CoCID,CoCName,y2015,15funding,perCap15,y2016,16funding,perCap16,pop15-16,fund15-16,y2017,17funding,perCap17,pop16-17,fund16-17,y2018,18funding,perCap18,pop17-18,fund17-18,y2019,19funding,perCap19,pop18-19,fund18-19,avgPop,avgFund
LA-509,Louisiana Balance of State CoC,907,13167485,14517.62404,797,14660729,18394.8921,-110,3877.26806,706,16272579,23048.97875,-91,4654.086658,575,18368336,31944.93217,-131,8895.95342,593,20125458,33938.37774,18,1993.445566,715.6,24368.96096
PA-600,"Pittsburgh, McKeesport, Penn Hills/Allegheny County CoC",1424,18215968,12792.11236,1156,17787724,15387.3045,-268,2595.192139,1145,17220390,15039.64192,-11,-347.6625769,783,20406399,26061.81226,-362,11022.17034,774,20784347,26853.1615,-9,791.3492382,1056.4,19226.80651
MI-502,"Dearborn, Dearborn Heights, Westland/Wayne County CoC",333,3380983,10153.1021,277,3405983,12295.96751,-56,2142.865407,226,3702413,16382.35841,-51,4086.390898,211,4253480,20158.67299,-15,3776.314579,222,5281409,23790.13063,11,3631.457645,253.8,16556.04633
NY-522,"Jefferson, Lewis, St. Lawrence Counties CoC",86,1267042,14733.04651,119,1297889,10906.63025,33,-3826.41626,169,1253146,7415.065089,50,-3491.565163,96,1294337,13482.67708,-73,6067.611995,53,1432375,27025.9434,-43,13543.26631,104.6,14712.67247
CT-505,Connecticut Balance of State CoC,3134,27081272,8641.120613,3016,34391375,11402.9758,-118,2761.855183,2610,34305156,13143.73793,-406,1740.762135,3112,37553278,12067.24871,502,-1076.489216,2262,43687282,19313.5641,-850,7246.315388,2826.8,12913.72943
IL-514,DuPage County CoC,672,4406678,6557.556548,555,4411902,7949.372973,-117,1391.816425,331,4526372,13674.83988,-224,5725.466906,295,4880469,16543.96271,-36,2869.122833,309,5136314,16622.3754,14,78.41269267,432.4,12269.6215
GA-508,DeKalb County CoC,684,4651682,6800.704678,473,4781918,10109.76321,-211,3309.058535,460,4866729,10579.84565,-13,470.0824386,321,5144877,16027.65421,-139,5447.808553,375,5803531,15476.08267,54,-551.5715389,462.6,11798.81008
LA-503,New Orleans/Jefferson Parish CoC,1703,18367757,10785.52965,1626,18924229,11638.51722,-77,852.9875666,1301,18524402,14238.58724,-325,2600.07002,1188,21224142,17865.43939,-113,3626.852153,1179,22728831,19278.05852,-9,1412.61913,1399.4,14761.22641
NJ-501,Bergen County CoC,340,4213917,12393.87353,296,4787854,16175.18243,-44,3781.308903,302,4869363,16123.71854,6,-51.46388939,354,5363543,15151.25141,52,-972.4671306,271,5480285,20222.45387,-83,5071.202462,312.6,16013.29596
OH-504,Youngstown/Mahoning County CoC,368,1983615,5390.258152,346,1749421,5056.130058,-22,-334.1280944,262,1726847,6591.019084,-84,1534.889026,180,1919042,10661.34444,-82,4070.32536,148,1944838,13140.7973,-32,2479.452853,260.8,8167.909807
IL-504,Madison County CoC,168,1832242,10906.20238,199,1891803,9506.547739,31,-1399.654642,176,1814852,10311.65909,-23,805.1113522,146,1841444,12612.63014,-30,2300.971046,101,1869154,18506.47525,-45,5893.845111,158,12368.70292
MI-509,Washtenaw County CoC,372,5708538,15345.53226,342,5733891,16765.76316,-30,1420.2309,302,5588663,18505.50662,-40,1739.743465,282,5973900,21184.04255,-20,2678.535931,273,6225899,22805.49084,-9,1621.448289,314.2,18921.26709
NY-501,"Elmira/Steuben, Allegany, Livingston, Chemung, Schuyler Counties CoC",648,0,0,506,1527165,3018.112648,-142,3018.112648,226,1497301,6625.225664,-280,3607.113015,233,1709455,7336.716738,7,711.4910745,240,1746038,7275.158333,7,-61.55840486,370.6,4851.042677
OH-505,"Dayton, Kettering/Montgomery County CoC",971,8478888,8732.119464,751,8907293,11860.57656,-220,3128.4571,619,9204284,14869.60258,-132,3009.02602,680,10328847,15189.48088,61,319.8782975,681,10687124,15693.28047,1,503.7995875,740.4,13269.01199
PA-504,"Lower Merion, Norristown, Abington/Montgomery County CoC",429,2865555,6679.615385,398,2973442,7470.959799,-31,791.3444144,310,2888253,9316.945161,-88,1845.985362,291,3224611,11081.13746,-19,1764.192296,246,3325998,13520.31707,-45,2439.179616,334.8,9613.794975
MD-508,"Charles, Calvert, St.Mary's Counties CoC",981,2521547,2570.384302,464,2648561,5708.105603,-517,3137.721302,419,2750403,6564.207637,-45,856.1020338,492,2923962,5943.012195,73,-621.1954421,306,2852219,9320.977124,-186,3377.964929,532.4,6021.337372
CT-503,"Bridgeport, Stamford, Norwalk, Danbury/Fairfield County CoC",913,10169085,11138.09967,886,10192385,11503.82054,-27,365.7208703,778,10265112,13194.23136,-108,1690.410821,864,11467362,13272.40972,86,78.17835975,771,13660263,17717.59144,-93,4445.181717,842.4,13365.23055
WV-501,"Huntington/Cabell, Wayne Counties CoC",227,2205883,9717.546256,228,2105300,9233.77193,1,-483.7743257,205,2366017,11541.54634,-23,2307.774412,190,2614928,13762.77895,-15,2221.232606,171,2785647,16290.33333,-19,2527.554386,204.2,12109.19536
PA-601,Western Pennsylvania CoC,1002,8792731,8775.180639,986,8977926,9105.401623,-16,330.220984,837,9160668,10944.64516,-149,1839.243539,748,9900291,13235.68316,-89,2291.037994,727,11021412,15160.12655,-21,1924.443392,860,11444.20743
MD-601,Montgomery County CoC,1100,8202360,7456.690909,981,8288534,8449.066259,-119,992.3753498,894,8762940,9801.946309,-87,1352.88005,840,9232284,10990.81429,-54,1188.867977,647,8930720,13803.27666,-193,2812.462376,892.4,10100.35888
IL-506,"Joliet, Bolingbrook/Will County CoC",340,3519280,10350.82353,290,3752278,12938.88966,-50,2588.066126,282,3966130,14064.29078,-8,1125.401125,341,4148711,12166.30792,59,-1897.982862,278,4609607,16581.32014,-63,4415.012226,306.2,13220.32641
OH-508,"Canton, Massillon, Alliance/Stark County CoC",472,2676332,5670.194915,460,2696040,5860.956522,-12,190.7616065,319,2942080,9222.821317,-141,3361.864795,278,2965295,10666.52878,-41,1443.70746,273,3128202,11458.61538,-5,792.0866076,360.4,8575.823383
MI-512,"Grand Traverse, Antrim, Leelanau Counties CoC",302,670841,2221.327815,243,675516,2779.901235,-59,558.57342,228,672325,2948.79386,-15,168.8926251,235,707619,3011.144681,7,62.3508212,168,1329117,7911.410714,-67,4900.266033,235.2,3774.515661
MD-600,Prince George's County CoC,625,4944748,7911.5968,544,4903772,9014.286765,-81,1102.689965,525,5239911,9980.782857,-19,966.4960924,478,5817344,12170.17573,-47,2189.392875,447,6079178,13599.95078,-31,1429.775051,523.8,10535.35859
WI-501,Milwaukee City & County CoC,1521,10127898,6658.710059,1415,10453943,7387.945583,-106,729.2355239,900,10281986,11424.42889,-515,4036.483306,871,10641309,12217.34673,-29,792.917839,885,10813357,12218.48249,14,1.135757977,1118.4,9981.382749
IL-510,Chicago CoC,6786,63499383,9357.409814,5889,64921879,11024.26201,-897,1666.8522,5657,67054040,11853.28619,-232,829.0241802,5450,73193688,13430.0345,-207,1576.748301,5290,76142315,14393.63233,-160,963.5978297,5814.4,12011.72497
IL-502,"Waukegan, North Chicago/Lake County CoC",386,2105513,5454.696891,299,2137755,7149.682274,-87,1694.985383,228,2002113,8781.197368,-71,1631.515094,277,2321293,8380.119134,49,-401.0782348,252,2593489,10291.62302,-25,1911.503882,288.4,8011.463737
IL-508,"East St. Louis, Belleville/St. Clair County CoC",318,3191970,10037.64151,240,3189769,13290.70417,-78,3253.062657,300,3147676,10492.25333,60,-2798.450833,250,3374043,13496.172,-50,3003.918667,247,3662079,14826.23077,-3,1330.058769,271,12428.60036
MN-511,Southwest Minnesota CoC,124,984023,7935.669355,123,984744,8006.04878,-1,70.37942565,108,969625,8978.009259,-15,971.9604788,65,1106623,17024.96923,-43,8046.959972,88,1112663,12643.89773,23,-4381.071503,101.6,10917.71887
PR-502,Puerto Rico Balance of Commonwealth CoC,2422,13017927,5374.866639,2343,13057303,5572.899274,-79,198.0326353,1883,13097961,6955.90069,-460,1383.001416,1643,13407969,8160.662812,-240,1204.762122,1345,13528049,10058.029,-298,1897.366184,1927.2,7224.471682
OH-502,Cleveland/Cuyahoga County CoC,1943,26740229,13762.34122,1697,26997332,15908.85798,-246,2146.51676,1727,27022106,15646.84771,30,-262.0102719,1808,28162915,15576.83352,81,-70.0141951,1618,29733277,18376.5618,-190,2799.728287,1758.6,15854.28845
PA-508,Scranton/Lackawanna County CoC,233,2588315,11108.64807,242,2586130,10686.4876,9,-422.1604654,197,2683752,13623.1066,-45,2936.618996,159,2906992,18282.96855,-38,4659.861954,186,2887145,15522.28495,27,-2760.683607,203.4,13844.69915
NY-505,"Syracuse, Auburn/Onondaga, Oswego, Cayuga Counties CoC",922,8296514,8998.388286,867,8658238,9986.433679,-55,988.045393,798,8475964,10621.50877,-69,635.0750926,722,9472298,13119.52632,-76,2498.017544,732,9755656,13327.39891,10,207.8725913,808.2,11210.65119
VA-500,"Richmond/Henrico, Chesterfield, Hanover Counties CoC",818,4468766,5463.03912,762,4346322,5703.834646,-56,240.7955259,662,4495669,6791.040785,-100,1087.20614,609,4754160,7806.502463,-53,1015.461678,497,4813352,9684.812877,-112,1878.310414,669.6,7089.845978
OH-500,Cincinnati/Hamilton County CoC,1063,17982669,16916.90405,1116,17469842,15653.98029,53,-1262.923758,1162,16347894,14068.75559,46,-1585.224693,1114,19476832,17483.6912,-48,3414.935609,1082,22793209,21065.81238,-32,3582.121182,1107.4,17037.8287
MO-501,St.Louis City CoC,1312,10819284,8246.405488,1248,11327426,9076.463141,-64,830.0576532,1336,11487718,8598.591317,88,-477.8718237,949,12494002,13165.43941,-387,4566.848093,1031,12602939,12223.99515,82,-941.4442596,1175.2,10262.1789
NJ-514,Trenton/Mercer County CoC,600,3538791,5897.985,465,3837859,8253.460215,-135,2355.475215,478,3884113,8125.759414,13,-127.7008008,479,4332613,9045.121086,1,919.3616714,448,4386254,9790.745536,-31,745.6244501,494,8222.61425
IL-515,South Central Illinois CoC,122,905114,7418.967213,133,902088,6782.616541,11,-636.3506718,108,882109,8167.675926,-25,1385.059385,92,1047588,11386.82609,-16,3219.150161,94,1061142,11288.74468,2,-98.08140611,109.8,9008.96609
AL-506,Tuscaloosa City & County CoC,339,232472,685.7581121,177,216199,1221.463277,-162,535.7051647,200,211879,1059.395,23,-162.0682768,57,203299,3566.649123,-143,2507.254123,44,199669,4537.931818,-13,971.2826954,163.4,2214.239466
MI-501,Detroit CoC,2597,26130090,10061.6442,2335,23271331,9966.308779,-262,-95.33542541,2078,25196727,12125.47016,-257,2159.161384,1769,26921844,15218.67948,-309,3093.209316,1965,27280221,13883.06412,196,-1335.615358,2148.8,12251.03335
LA-502,"Shreveport, Bossier/Northwest Louisiana CoC",390,3890343,9975.238462,478,3884305,8126.161088,88,-1849.077374,349,3925902,11249.00287,-129,3122.841777,375,4010367,10694.312,26,-554.6908653,292,4010656,13735.12329,-83,3040.811288,376.8,10755.96754
MI-503,"St. Clair Shores, Warren/Macomb County CoC",450,1197681,2661.513333,403,1198139,2973.049628,-47,311.5362945,354,1180474,3334.672316,-49,361.6226886,270,1276212,4726.711111,-84,1392.038795,265,1696753,6402.841509,-5,1676.130398,348.4,4019.75758
TX-700,"Houston, Pasadena, Conroe/Harris, Ft. Bend, Montgomery, Counties CoC",4609,32098014,6964.203515,4031,33233058,8244.370628,-578,1280.167113,3605,32456552,9003.204438,-426,758.8338106,4143,38155969,9209.743905,538,206.5394671,3938,41760038,10604.37735,-205,1394.633444,4065.2,8805.179967
VA-507,Portsmouth CoC,174,1157730,6653.62069,169,1204885,7129.497041,-5,475.8763518,151,1168615,7739.172185,-18,609.675144,135,1200937,8895.82963,-16,1156.657444,119,1209142,10160.85714,-16,1265.027513,149.6,8115.795338
NJ-511,Paterson/Passaic County CoC,459,3745554,8160.248366,432,4090373,9468.456019,-27,1308.207653,449,4137117,9214.069042,17,-254.3869762,434,4557884,10502.03687,-15,1287.967824,391,4511971,11539.56777,-43,1037.530909,433,9776.875614
VA-508,Lynchburg CoC,237,338887,1429.902954,174,359813,2067.890805,-63,637.987851,125,357393,2859.144,-49,791.2531954,112,371921,3320.723214,-13,461.5792143,78,371673,4765.038462,-34,1444.315247,145.2,2888.539887
MA-511,"Quincy, Brockton, Weymouth, Plymouth City and County CoC",1803,5453087,3024.452024,1692,5530889,3268.846927,-111,244.3949023,1109,5547318,5002.090171,-583,1733.243245,1090,6670761,6119.96422,-19,1117.874049,1088,6878921,6322.537684,-2,202.5734636,1356.4,4747.578205
UT-504,Provo/Mountainland CoC,203,1089919,5369.059113,178,978525,5497.331461,-25,128.2723474,171,1059020,6193.099415,-7,695.7679545,173,1198418,6927.271676,2,734.1722611,161,1393707,8656.565217,-12,1729.293541,177.2,6528.665377
PA-509,Eastern Pennsylvania CoC,2410,10803770,4482.892116,2599,10978472,4224.11389,189,-258.7782262,2170,11585801,5339.078802,-429,1114.964912,1998,12487079,6249.789289,-172,910.7104874,1843,14065097,7631.631579,-155,1381.84229,2204,5585.501135
NJ-508,Monmouth County CoC,456,3073031,6739.10307,344,3473553,10097.53779,-112,3358.434721,299,3381878,11310.62876,-45,1213.090972,335,3617597,10798.79701,36,-511.8317476,359,3525111,9819.250696,24,-979.5463185,358.6,9753.063467
MI-506,"Grand Rapids, Wyoming/Kent County CoC",912,5503523,6034.564693,800,5511453,6889.31625,-112,854.751557,912,5517588,6049.986842,112,-839.3294079,723,6297388,8710.080221,-189,2660.093379,759,6868810,9049.815547,36,339.7353255,821.2,7346.752711
IL-519,West Central Illinois CoC,100,650720,6507.2,102,650720,6379.607843,2,-127.5921569,80,641558,8019.475,-22,1639.867157,67,665749,9936.552239,-13,1917.077239,68,645899,9498.514706,1,-438.0375329,83.4,8068.269958
VA-503,Virginia Beach CoC,419,1602194,3823.852029,389,1401011,3601.570694,-30,-222.2813346,349,1642276,4705.661891,-40,1104.091197,243,1858231,7647.041152,-106,2941.379261,260,1763592,6783.046154,17,-863.9949984,332,5312.234384
PR-503,South-Southeast Puerto Rico CoC,2096,5960026,2843.523855,2075,5658674,2727.071807,-21,-116.4520477,1642,5515253,3358.862972,-433,631.7911648,1539,5275620,3427.953216,-103,69.09024439,1190,6874505,5776.894958,-349,2348.941742,1708.4,3626.861362
OH-506,"Akron, Barberton/Summit County CoC",760,4366303,5745.135526,679,4711705,6939.182622,-81,1194.047095,507,4575345,9024.349112,-172,2085.166491,587,4835866,8238.272572,80,-786.07654,546,4722195,8648.708791,-41,410.4362188,615.8,7719.129725
LA-500,Lafayette/Acadiana CoC,493,2474843,5019.965517,463,2477638,5351.269978,-30,331.3044612,357,2540376,7115.89916,-106,1764.629181,363,2840362,7824.688705,6,708.7895456,360,2847843,7910.675,-3,85.98629477,407.2,6644.499672
LA-506,Slidell/Southeast Louisiana CoC,243,2291529,9430.160494,275,2232580,8118.472727,32,-1311.687767,248,2132851,8600.205645,-27,481.7329179,194,2492504,12847.95876,-54,4247.753118,215,2647157,12312.35814,21,-535.6006234,235,10261.83115
MI-504,"Pontiac, Royal Oak/Oakland County CoC",485,5793784,11945.94639,438,5807618,13259.40183,-47,1313.455435,412,5868791,14244.63835,-26,985.236523,427,6256918,14653.20375,15,408.5653976,425,6295287,14812.44,-2,159.2362529,437.4,13783.12606
PA-503,"Wilkes-Barre, Hazleton/Luzerne County CoC",174,3995242,22961.16092,169,3917394,23179.84615,-5,218.6852343,174,4021709,23113.27011,5,-66.5760389,165,4261680,25828.36364,-9,2715.093521,164,4234949,25822.85976,-1,-5.503880266,169.2,24181.10012
AL-507,Alabama Balance of State CoC,638,1045984,1639.473354,827,916817,1108.605804,189,-530.8675501,764,1104980,1446.308901,-63,337.7030964,730,1185251,1623.631507,-34,177.3226063,323,1441654,4463.325077,-407,2839.693571,656.4,2056.268929
MD-501,Baltimore CoC,2796,20113771,7193.766452,2725,21106170,7745.383486,-71,551.6170342,2669,20831889,7805.128887,-56,59.74540099,2508,23391054,9326.576555,-161,1521.447668,2294,22639730,9869.106364,-214,542.5298094,2598.4,8387.992349
NC-502,Durham City & County CoC,813,1322432,1626.607626,354,1282978,3624.231638,-459,1997.624012,354,1247410,3523.757062,0,-100.4745763,338,1461135,4322.884615,-16,799.1275532,361,1522268,4216.808864,23,-106.0757511,444,3462.857961
MA-516,Massachusetts Balance of State CoC,2651,11715812,4419.393436,2551,11855946,4647.568013,-100,228.1745761,2080,12430249,5976.08125,-471,1328.513237,2296,12607536,5491.087108,216,-484.994142,1918,13438107,7006.312304,-378,1515.225196,2299.2,5508.088422
KY-501,Louisville-Jefferson County CoC,1161,9064742,7807.701981,1116,9448427,8466.332437,-45,658.6304562,1034,9276354,8971.32882,-82,504.9963828,926,9910618,10702.61123,-108,1731.282411,1071,11049588,10317.07563,145,-385.5356008,1061.6,9253.01002
IL-507,"Peoria, Pekin/Fulton, Tazewell, Peoria, Woodford Counties CoC",451,1786354,3960.873614,378,1788852,4732.412698,-73,771.5390842,329,1738227,5283.364742,-49,550.9520432,400,1802286,4505.715,71,-777.6497416,285,1829851,6420.529825,-115,1914.814825,368.6,4980.579176
MI-500,Michigan Balance of State CoC,1745,8790201,5037.36447,1466,8872886,6052.446112,-279,1015.081642,1465,8832530,6029.030717,-1,-23.41539515,1343,9280618,6910.363366,-122,881.3326489,1245,9303379,7472.593574,-98,562.2302087,1452.8,6300.359648
NC-509,"Gastonia/Cleveland, Gaston, Lincoln Counties CoC",281,0,0,328,835476,2547.182927,47,2547.182927,249,779167,3129.184739,-79,582.0018121,331,792300,2393.655589,82,-735.5291498,324,788859,2434.75,-7,41.09441088,302.6,2100.954651
NE-502,Lincoln CoC,714,2230675,3124.194678,694,2257143,3252.367435,-20,128.1727573,606,2256141,3723.00495,-88,470.6375153,451,2372628,5260.815965,-155,1537.811014,449,2479264,5521.746102,-2,260.9301379,582.8,4176.425826
MS-501,Mississippi Balance of State CoC,809,3304285,4084.406675,785,3241980,4129.910828,-24,45.50415312,697,3120635,4477.238164,-88,347.3273355,560,2785536,4974.171429,-137,496.933265,480,3088029,6433.39375,-80,1459.222321,666.2,4819.824169
PA-603,Beaver County CoC,120,1534995,12791.625,131,1347740,10288.0916,11,-2503.533397,98,1283884,13100.85714,-33,2812.76554,117,1478372,12635.65812,19,-465.1990232,123,1859523,15118.07317,6,2482.415051,117.8,12786.86101
NJ-506,"Jersey City, Bayonne/Hudson County CoC",917,5243399,5717.992366,829,6557997,7910.732207,-88,2192.739841,822,6389936,7773.644769,-7,-137.0874386,860,7191193,8361.852326,38,588.2075567,890,7157049,8041.62809,30,-320.2242357,863.6,7561.169952
FL-600,Miami-Dade County CoC,4152,29730926,7160.627649,4235,29898527,7059.864699,83,-100.7629504,3721,29811201,8011.610051,-514,951.7453521,3516,31480996,8953.639363,-205,942.0293119,3472,32867600,9466.474654,-44,512.8352915,3819.2,8130.443283
MI-523,Eaton County CoC,135,895163,6630.837037,120,929250,7743.75,-15,1112.912963,107,900050,8411.682243,-13,667.932243,122,994002,8147.557377,15,-264.1248659,114,1016964,8920.736842,-8,773.1794651,119.6,7970.9127
VA-604,Prince William County CoC,409,527157,1288.892421,400,564657,1411.6425,-9,122.7500795,400,552650,1381.625,0,-30.0175,374,721514,1929.181818,-26,547.5568182,280,994546,3551.95,-94,1622.768182,372.6,1912.658348
IL-511,Cook County CoC,895,11372915,12707.1676,952,11770688,12364.16807,57,-342.9995305,780,11731317,15040.15,-172,2675.981933,873,13107890,15014.76518,93,-25.38482245,897,13403353,14942.42252,24,-72.34265804,879.4,14013.73467
SC-500,Charleston/Low Country CoC,606,1717517,2834.186469,550,1719596,3126.538182,-56,292.3517132,425,1705708,4013.430588,-125,886.8924064,451,1952972,4330.314856,26,316.8842676,403,2041163,5064.920596,-48,734.6057397,487,3873.878138
NY-508,"Buffalo, Niagara Falls/Erie, Niagara, Orleans, Genesee, Wyoming Counties CoC",919,10873277,11831.63983,962,11765574,12230.3264,43,398.6865774,925,11655799,12600.86378,-37,370.5373805,957,12207363,12755.8652,32,155.00142,924,12973261,14040.32576,-33,1284.460554,937.4,12691.80419
IN-502,Indiana Balance of State CoC,4197,10496669,2500.993329,4179,11424156,2733.705671,-18,232.7123426,3655,13545129,3705.917647,-524,972.2119758,3576,17126143,4789.189877,-79,1083.27223,3904,18346413,4699.388576,328,-89.80130114,3902.2,3685.83902
GA-505,Columbus-Muscogee CoC,371,1333949,3595.549865,329,1360498,4135.25228,-42,539.7024144,319,1360522,4264.959248,-10,129.706968,276,1524407,5523.213768,-43,1258.25452,278,1610376,5792.719424,2,269.5056563,314.6,4662.338917
MI-519,Holland/Ottawa County CoC,285,1017124,3568.85614,261,1017437,3898.226054,-24,329.3699133,258,1017251,3942.833333,-3,44.60727969,226,1160414,5134.575221,-32,1191.741888,225,1292064,5742.506667,-1,607.9314454,251,4457.399483
ND-500,North Dakota Statewide CoC,1305,2047642,1569.07433,923,1903991,2062.828819,-382,493.7544896,1089,1761315,1617.369146,166,-445.4596731,542,1876781,3462.695572,-547,1845.326426,557,2058043,3694.870736,15,232.1751641,883.2,2481.367721
VA-600,Arlington County CoC,239,2459677,10291.53556,174,2539044,14592.2069,-65,4300.671332,232,2611996,11258.60345,58,-3333.603448,221,2832598,12817.18552,-11,1558.582072,215,2659145,12368.11628,-6,-449.0692413,216.2,12265.52954
FL-603,"Ft Myers, Cape Coral/Lee County CoC",614,1762276,2870.156352,439,1661056,3783.726651,-175,913.5702997,431,1667288,3868.417633,-8,84.69098193,728,1835581,2521.402473,297,-1347.015161,372,1825537,4907.357527,-356,2385.955054,516.8,3590.212127
IL-501,"Rockford/DeKalb, Winnebago, Boone Counties CoC",428,1470693,3436.198598,336,1528983,4550.544643,-92,1114.346045,381,1453190,3814.146982,45,-736.3976612,356,1524907,4283.446629,-25,469.2996476,403,2200682,5460.74938,47,1177.30275,380.8,4309.017246
MI-517,Jackson City & County CoC,159,905738,5696.465409,169,818093,4840.786982,10,-855.6784266,140,825123,5893.735714,-29,1052.948732,81,824043,10173.37037,-59,4279.634656,113,870459,7703.176991,32,-2470.193379,132.4,6861.507093
CA-607,Pasadena CoC,632,3112977,4925.596519,530,3176554,5993.498113,-102,1067.901594,575,3163253,5501.309565,45,-492.188548,677,3561687,5260.985229,102,-240.3243363,542,3749042,6917.051661,-135,1656.066432,591.2,5719.688217
CA-512,Daly/San Mateo County CoC,1483,9455481,6375.914363,1361,8583356,6306.653931,-122,-69.26043185,1253,11280155,9002.517957,-108,2695.864026,1238,12756571,10304.1769,-15,1301.658941,1512,12625516,8350.208995,274,-1953.967904,1369.4,8067.894429
CA-507,Marin County CoC,1318,3264434,2476.808801,1258,3328338,2645.737679,-60,168.9288776,1117,4195529,3756.068935,-141,1110.331256,1095,4496522,4106.412785,-22,350.3438507,1034,4600616,4449.338491,-61,342.9257059,1164.4,3486.873338
PA-512,York City & County CoC,345,1184845,3434.333333,365,1196933,3279.268493,20,-155.0648402,288,1223485,4248.211806,-77,968.9433124,324,1370705,4230.570988,36,-17.6408179,321,1727758,5382.423676,-3,1151.852688,328.6,4114.961659
NH-500,New Hampshire Balance of State CoC,718,3552510,4947.785515,670,3556085,5307.589552,-48,359.8040369,767,3751496,4891.129074,97,-416.4604779,742,4193853,5652.092992,-25,760.9639176,669,4589707,6860.54858,-73,1208.455588,713.2,5531.829143
NH-502,Nashua/Hillsborough County CoC,327,1814588,5549.198777,296,1869026,6314.277027,-31,765.0782503,295,1814588,6151.145763,-1,-163.1312643,281,1936674,6892.078292,-14,740.9325291,266,1981250,7448.308271,-15,556.2299789,293,6471.001626
RI-500,Rhode Island Statewide CoC,1111,5985905,5387.853285,1160,5932887,5114.557759,49,-273.2955267,1180,5561271,4712.941525,20,-401.6162332,1101,7160233,6503.390554,-79,1790.449029,1055,7664476,7264.906161,-46,761.5156071,1121.4,5796.729857
IN-503,Indianapolis CoC,1666,4404410,2643.703481,1619,5030641,3107.252007,-47,463.548526,1783,5064847,2840.632081,164,-266.6199266,1682,5575184,3314.615933,-101,473.9838526,1567,7066690,4509.693682,-115,1195.077749,1663.4,3283.179437
LA-507,Alexandria/Central Louisiana CoC,154,704860,4577.012987,167,719772,4310.011976,13,-267.001011,159,716695,4507.515723,-8,197.5037472,177,729971,4124.129944,18,-383.3857798,114,732556,6425.929825,-63,2301.799881,154.2,4788.920091
MS-500,"Jackson/Rankin, Madison Counties CoC",762,1375970,1805.734908,633,1313447,2074.955766,-129,269.2208581,511,917234,1794.978474,-122,-279.9772926,446,1433023,3213.056054,-65,1418.07758,408,1489445,3650.60049,-38,437.5444364,552,2507.865138
IL-516,Decatur/Macon County CoC,238,794780,3339.411765,157,790791,5036.88535,-81,1697.473586,130,767758,5905.830769,-27,868.9454189,161,869672,5401.689441,31,-504.1413282,169,869146,5142.87574,8,-258.8137013,171,4965.338613
WV-503,"Charleston/Kanawha, Putnam, Boone, Clay Counties CoC",385,1223874,3178.893506,320,1223910,3824.71875,-65,645.8252435,319,1135690,3560.15674,-1,-264.5620102,317,1336441,4215.902208,-2,655.7454684,293,1459428,4980.982935,-24,765.080727,326.8,3952.130828
GA-501,Georgia Balance of State CoC,5797,15845827,2733.452993,5575,16095286,2887.046816,-222,153.5938232,3716,17416695,4686.946986,-1859,1799.90017,3730,19242078,5158.734048,14,471.7870623,4183,18905191,4519.529285,453,-639.2047631,4600.2,3997.142026
NY-512,Troy/Rensselaer County CoC,189,3210595,16987.27513,179,3292226,18392.32402,-10,1405.04889,194,3219814,16596.97938,15,-1795.344641,178,3529625,19829.35393,-16,3232.374551,199,3735842,18773.07538,21,-1056.278556,187.8,18115.80157
WV-508,West Virginia Balance of State CoC,1109,3806212,3432.111812,748,4018831,5372.768717,-361,1940.656904,667,4210305,6312.301349,-81,939.5326327,628,4375910,6968.009554,-39,655.7082048,797,4145781,5201.732748,169,-1766.276806,789.8,5457.384836
AL-500,"Birmingham/Jefferson, St. Clair, Shelby Counties CoC",1153,8997707,7803.735473,1228,8909627,7255.39658,75,-548.3388929,1092,9109238,8341.79304,-136,1086.39646,901,9482514,10524.43285,-191,2182.639812,981,9388061,9569.888889,80,-954.5439635,1071,8699.049367
VT-500,Vermont Balance of State CoC,1052,3231669,3071.928707,785,3335037,4248.454777,-267,1176.52607,934,3364072,3601.79015,149,-646.6646272,932,3669079,3936.780043,-2,334.989893,780,3767758,4830.458974,-152,893.6789314,896.6,3937.88253
VA-601,Fairfax County CoC,1204,8373285,6954.555648,1059,8421041,7951.880076,-145,997.3244277,964,8744225,9070.772822,-95,1118.892746,987,9126856,9247.067882,23,176.2950609,1034,8984188,8688.769826,47,-558.2980566,1049.6,8382.609251
IA-501,Iowa Balance of State CoC,1975,4584927,2321.482025,1923,4755436,2472.925637,-52,151.4436117,1792,4745983,2648.428013,-131,175.5023764,1721,5206206,3025.105171,-71,376.677158,1379,5571658,4040.361131,-342,1015.25596,1758,2901.660396
CA-606,Long Beach CoC,2345,7533708,3212.668657,2250,7641265,3396.117778,-95,183.4491211,1863,7801973,4187.854536,-387,791.7367579,1873,8467853,4521.010678,10,333.1561424,1894,9330143,4926.157867,21,405.1471889,2045,4048.761903
AZ-501,Tucson/Pima County CoC,1863,8428109,4523.944713,1765,8414896,4767.646459,-98,243.7017461,1574,8395741,5334.015883,-191,566.3694242,1380,8584348,6220.542029,-194,886.5261459,1372,8497232,6193.317784,-8,-27.22424473,1590.8,5407.893374
GA-507,Savannah/Chatham County CoC,1100,3588586,3262.350909,1070,3389764,3168.003738,-30,-94.34717077,926,3168106,3421.280778,-144,253.2770392,1009,3450386,3419.609514,83,-1.671263167,686,3383018,4931.51312,-323,1511.903605,958.2,3640.551612
WI-503,Madison/Dane County CoC,771,3633373,4712.546044,629,3156593,5018.430843,-142,305.8847985,585,3129707,5349.926496,-44,331.4956531,614,3572436,5818.299674,29,468.3731785,578,3683891,6373.513841,-36,555.2141666,635.4,5454.54338
OR-506,"Hillsboro, Beaverton/Washington County CoC",591,3393016,5741.143824,571,3367261,5897.129597,-20,155.9857732,544,3369507,6193.946691,-27,296.817094,522,3853943,7383.032567,-22,1189.085876,530,3914303,7385.477358,8,2.444791441,551.6,6520.146008
NC-500,Winston-Salem/Forsyth County CoC,571,1889617,3309.311734,544,1896891,3486.931985,-27,177.6202515,453,1956291,4318.523179,-91,831.5911935,440,2225764,5058.554545,-13,740.0313666,454,2235705,4924.460352,14,-134.094193,492.4,4219.556359
IA-502,Des Moines/Polk County CoC,830,3127223,3767.738554,793,3370014,4249.702396,-37,481.9638417,676,3315621,4904.764793,-117,655.0623969,764,3537981,4630.865183,88,-273.8996097,681,3631979,5333.302496,-83,702.4373131,748.8,4577.274685
NJ-515,Elizabeth/Union County CoC,504,4467480,8864.047619,513,4598725,8964.376218,9,100.3285993,480,4114982,8572.879167,-33,-391.4970517,478,4321987,9041.813808,-2,468.9346409,437,4551474,10415.27231,-41,1373.458504,482.4,9171.677825
TN-500,Chattanooga/Southeast Tennessee CoC,636,2612695,4108.011006,527,2589462,4913.590133,-109,805.5791265,576,2550503,4427.956597,49,-485.6335356,623,2556777,4103.975923,47,-323.9806743,463,2615953,5650.006479,-160,1546.030557,565,4640.708028
NJ-510,Lakewood Township/Ocean County CoC,605,462780,764.9256198,429,566500,1320.512821,-176,555.5872007,224,574359,2564.102679,-205,1243.589858,354,613109,1731.946328,130,-832.1563509,305,700450,2296.557377,-49,564.6110494,383.4,1735.608965
PA-511,"Bristol, Bensalem/Bucks County CoC",487,934433,1918.753593,530,1174207,2215.484906,43,296.7313122,511,1157695,2265.547945,-19,50.06303955,397,1293954,3259.329975,-114,993.7820296,359,1236684,3444.802228,-38,185.4722536,456.8,2620.78373
TX-604,Waco/McLennan County CoC,255,978750,3838.235294,267,988312,3701.543071,12,-136.692223,221,964841,4365.79638,-46,664.2533089,188,1043307,5549.505319,-33,1183.708939,193,1034214,5358.621762,5,-190.8835575,224.8,4562.740365
TX-701,"Bryan, College Station/Brazos Valley CoC",168,310636,1849.02381,161,288891,1794.354037,-7,-54.66977226,102,285591,2799.911765,-59,1005.557727,197,298095,1513.172589,95,-1286.739176,123,412562,3354.162602,-74,1840.990013,150.2,2262.12496
TX-503,Austin/Travis County CoC,1832,5687295,3104.418668,2138,5686658,2659.802619,306,-444.6160489,2036,5763762,2830.924361,-102,171.1217422,2147,6780538,3158.145319,111,327.2209576,2255,10383512,4604.661641,108,1446.516322,2081.6,3271.590522
ME-500,Maine Statewide CoC,2372,11977853,5049.685076,2241,11810751,5270.303882,-131,220.6188063,2280,12583115,5518.910088,39,248.6062055,2516,13091730,5203.390302,236,-315.5197857,2106,13792998,6549.381766,-410,1345.991464,2303,5518.334223
MD-513,"Wicomico, Somerset, Worcester Counties CoC",326,1203629,3692.113497,262,1231811,4701.568702,-64,1009.455205,260,1213694,4668.053846,-2,-33.51485614,292,1319789,4519.825342,32,-148.2285037,275,1413559,5140.214545,-17,620.389203,283,4544.355187
VT-501,Burlington/Chittenden County CoC,471,1036720,2201.104034,332,1143175,3443.298193,-139,1242.194159,291,1140058,3917.725086,-41,474.4268931,359,1205892,3359.030641,68,-558.6944452,309,1124840,3640.2589,-50,281.228259,352.4,3312.283371
MA-515,Fall River CoC,406,1749357,4308.761084,386,1775574,4599.932642,-20,291.1715587,297,1743743,5871.188552,-89,1271.25591,377,1768888,4692.01061,80,-1179.177942,320,1832924,5727.8875,-57,1035.87689,357.2,5039.956078
MD-503,Annapolis/Anne Arundel County CoC,335,2175878,6495.158209,390,2303378,5906.097436,55,-589.0607731,376,2353435,6259.135638,-14,353.0382024,366,2472691,6755.986339,-10,496.8507005,302,2385199,7898.009934,-64,1142.023595,353.8,6662.877511
MA-500,Boston CoC,6492,23987809,3694.979821,6240,24243260,3885.137821,-252,190.1579992,6135,25645902,4180.261125,-105,295.1233042,6188,29021101,4689.899968,53,509.638843,6242,31723357,5082.24239,54,392.3424226,6259.4,4306.504225
CA-501,San Francisco CoC,6775,30968697,4571.025387,6996,31804009,4546.027587,221,-24.99780026,6858,40532368,5910.231554,-138,1364.203967,6857,44537520,6495.190316,-1,584.9587621,8035,47849533,5955.137897,1178,-540.0524198,7104.2,5495.522548
FL-602,Punta Gorda/Charlotte County CoC,562,188639,335.6565836,388,189201,487.6314433,-174,151.9748597,222,199572,898.972973,-166,411.3415297,164,258810,1578.109756,-58,679.1367831,156,266960,1711.282051,-8,133.1722952,298.4,1002.330561
TN-509,Appalachian Regional CoC,577,1530908,2653.220104,448,1528834,3412.575893,-129,759.3557889,450,1496330,3325.177778,2,-87.39811508,360,1690283,4695.230556,-90,1370.052778,405,1631358,4028.044444,45,-667.1861111,448,3622.849755
IL-512,Bloomington/Central Illinois CoC,619,1093888,1767.185784,411,1022802,2488.569343,-208,721.3835595,433,965449,2229.674365,22,-258.8949782,387,1056875,2730.943152,-46,501.2687876,319,1000335,3135.846395,-68,404.9032425,433.8,2470.443808
KY-502,Lexington-Fayette County CoC,1258,1589681,1263.657393,1064,1501736,1411.406015,-194,147.7486224,1051,1446424,1376.235966,-13,-35.17004929,685,1820160,2657.167883,-366,1280.931917,787,2069653,2629.800508,102,-27.36737495,969,1867.653553
LA-505,Monroe/Northeast Louisiana CoC,191,1617421,8468.172775,188,1619854,8616.244681,-3,148.071906,185,1609261,8698.708108,-3,82.46342726,187,1746290,9338.449198,2,639.7410898,188,1847632,9827.829787,1,489.3805894,187.8,8989.88091
OR-501,"Portland, Gresham/Multnomah County CoC",3801,19118469,5029.852407,3914,21649478,5531.292284,113,501.4398768,4177,22269997,5331.576969,263,-199.715315,4019,24284354,6042.387161,-158,710.8101919,4015,25584408,6372.206227,-4,329.8190657,3985.2,5661.46301
KY-500,Kentucky Balance of State CoC,2119,7981008,3766.40302,2057,8113444,3944.309188,-62,177.9061678,1940,8104329,4177.489175,-117,233.1799871,2077,9430594,4540.488204,137,362.9990289,2221,11334495,5103.329581,144,562.8413771,2082.8,4306.403834
VA-603,Alexandria CoC,267,806998,3022.464419,224,808196,3608.017857,-43,585.5534377,211,826462,3916.881517,-13,308.8636594,226,867832,3839.964602,15,-76.91691482,198,860624,4346.585859,-28,506.6212568,225.2,3746.782851
MI-516,"Norton Shores, Muskegon City & County CoC",179,577163,3224.374302,191,571984,2994.680628,12,-229.6936734,135,554978,4110.948148,-56,1116.26752,159,596662,3752.591195,24,-358.3569532,136,617175,4538.051471,-23,785.4602756,160,3724.129149
MA-510,"Gloucester, Haverhill, Salem/Essex County CoC",1577,1724266,1093.38364,1206,1722258,1428.074627,-371,334.690987,747,1758097,2353.543507,-459,925.4688805,732,1816939,2482.157104,-15,128.6135965,760,1826756,2403.626316,28,-78.53078804,1004.4,1952.157039
PA-605,Erie City & County CoC,410,2128578,5191.653659,377,2267190,6013.766578,-33,822.1129197,369,2133084,5780.715447,-8,-233.0511311,336,2261076,6729.392857,-33,948.67741,356,2304738,6473.983146,20,-255.4097111,369.6,6037.902337
NY-504,Cattaragus County CoC,41,351754,8579.365854,27,328417,12163.59259,-14,3584.226739,34,318746,9374.882353,7,-2788.71024,33,274756,8325.939394,-1,-1048.942959,33,325404,9860.727273,0,1534.787879,33.6,9660.901493
IL-520,Southern Illinois CoC,346,891318,2576.063584,351,842336,2399.817664,5,-176.24592,435,813941,1871.128736,84,-528.6889282,282,1037157,3677.861702,-153,1806.732966,294,1133472,3855.346939,12,177.4852366,341.6,2876.043725
TX-603,El Paso City & County CoC,1107,2758173,2491.574526,1100,2763916,2512.650909,-7,21.07638335,1193,2474084,2073.834032,93,-438.8168772,892,3098524,3473.681614,-301,1399.847582,809,3028383,3743.365884,-83,269.6842695,1020.2,2859.021393
WI-500,Wisconsin Balance of State CoC,3597,8773084,2439.000278,3445,9101147,2641.84238,-152,202.8421023,3348,8739231,2610.28405,-97,-31.55833008,3147,10365263,3293.696536,-201,683.4124862,2875,10532123,3663.34713,-272,369.6505941,3282.4,2929.634075
CA-505,Richmond/Contra Costa County CoC,2031,11104352,5467.430822,1730,13076992,7558.954913,-301,2091.524091,1607,14234434,8857.768513,-123,1298.813599,2234,15857604,7098.300806,627,-1759.467707,2295,15239701,6640.392593,61,-457.9082131,1979.4,7124.569529
FL-504,"Deltona, Daytona Beach/Volusia, Flagler Counties CoC",1325,1090050,822.6792453,1005,1220958,1214.883582,-320,392.2043368,753,1305347,1733.528552,-252,518.6449704,683,1420440,2079.707174,-70,346.1786218,875,1727905,1974.748571,192,-104.9586028,928.2,1565.109425
AK-500,Anchorage CoC,1208,2949710,2441.812914,1105,2936677,2657.626244,-103,215.8133304,1128,2847097,2524.022163,23,-133.6040812,1094,3112658,2845.20841,-34,321.1862464,1111,3982876,3584.946895,17,739.7384852,1129.2,2810.723325
PA-502,"Upper Darby, Chester, Haverford/Delaware County CoC",436,5128363,11762.30046,406,5141756,12664.42365,-30,902.1231866,453,4887497,10789.1766,47,-1875.247045,414,5163693,12472.68841,-39,1683.511805,400,5161013,12902.5325,-14,429.8440942,421.8,12118.22432
NJ-507,New Brunswick/Middlesex County CoC,604,2407162,3985.36755,457,2949971,6455.078775,-147,2469.711225,546,3028900,5547.435897,89,-907.6428772,597,3103903,5199.167504,51,-348.2683932,620,3150525,5081.491935,23,-117.6755687,564.8,5253.708332
OR-507,Clackamas County CoC,494,2087390,4225.48583,463,2294569,4955.87257,-31,730.3867402,497,2353017,4734.440644,34,-221.4319263,383,2701875,7054.503916,-114,2320.063273,471,2503318,5314.900212,88,-1739.603704,461.6,5257.040635
NC-511,Fayetteville/Cumberland County CoC,593,698580,1178.043845,515,698580,1356.466019,-78,178.4221746,442,703508,1591.647059,-73,235.1810394,372,724109,1946.52957,-70,354.8825111,329,731891,2224.592705,-43,278.0631353,450.2,1659.45584
NY-523,"Glens Falls, Saratoga Springs/Saratoga, Washington, Warren, Hamilton Counties Co",282,1556533,5519.620567,268,1581004,5899.268657,-14,379.6480893,247,1529015,6190.34413,-21,291.0754728,257,1721987,6700.338521,10,509.9943918,268,1753455,6542.742537,11,-157.5959841,264.4,6170.462882
MA-507,"Pittsfield/Berkshire, Franklin, Hampshire Counties CoC",781,1797223,2301.181818,653,1571830,2407.090352,-128,105.908534,557,1660103,2980.436266,-96,573.3459135,651,1805851,2773.96467,94,-206.471596,546,1808722,3312.677656,-105,538.7129859,637.6,2755.070152
MS-503,Gulf Port/Gulf Coast Regional CoC,412,763991,1854.347087,320,812476,2538.9875,-92,684.6404126,264,805392,3050.727273,-56,511.7397727,346,830645,2400.708092,82,-650.0191802,296,847930,2864.628378,-50,463.9202859,327.6,2541.879666
NY-507,Schenectady City & County CoC,349,3867818,11082.57307,345,3881004,11249.28696,-4,166.7138906,274,3859980,14087.51825,-71,2838.231292,393,4054963,10317.97201,119,-3769.546238,372,4498061,12091.56183,-21,1773.589818,346.6,11765.78242
NC-505,Charlotte/Mecklenberg CoC,2001,3570229,1784.222389,1818,3659196,2012.759076,-183,228.5366871,1476,3685454,2496.920054,-342,484.1609783,1668,4089204,2451.561151,192,-45.35890312,1742,4771863,2739.301378,74,287.7402266,1741,2296.95281
UT-500,Salt Lake City & County CoC,2176,7389067,3395.710938,1891,7291633,3855.966684,-285,460.2557468,2047,7146067,3490.995115,156,-364.9715695,1804,7887527,4372.243348,-243,881.2482333,1844,8013120,4345.509761,40,-26.73358673,1952.4,3892.085169
CA-601,San Diego City and County CoC,8742,17859969,2043.007207,8669,18229194,2102.802399,-73,59.79519277,9160,19504303,2129.290721,491,26.48832117,8576,21394691,2494.716768,-584,365.4260472,8102,23876026,2946.929894,-474,452.2131261,8649.8,2343.349398
AL-501,Mobile City & County/Baldwin County CoC,578,3953258,6839.546713,623,3851277,6181.82504,45,-657.7216727,606,3744586,6179.184818,-17,-2.640221647,551,3811801,6917.969147,-55,738.7843285,505,3902469,7727.661386,-46,809.6922391,572.6,6769.237421
MN-502,Rochester/Southeast Minnesota CoC,451,1929728,4278.776053,423,2032007,4803.799054,-28,525.0230012,552,2134136,3866.188406,129,-937.6106486,497,2230636,4488.201207,-55,622.0128014,452,2311541,5114.028761,-45,625.8275538,475,4510.198696
MN-508,Moorhead/West Central Minnesota CoC,242,862869,3565.57438,211,824001,3905.218009,-31,339.6436293,215,801583,3728.293023,4,-176.9249862,246,863442,3509.926829,31,-218.366194,216,948825,4392.708333,-30,882.7815041,226,3820.344115
FL-507,"Orlando/Orange, Osceola, Seminole Counties CoC",2112,7444936,3525.064394,1670,7445861,4458.599401,-442,933.5350073,2074,7326489,3532.540501,404,-926.0588998,2053,8069046,3930.368242,-21,397.8277402,2010,8740225,4348.370647,-43,418.0024052,1983.8,3958.988637
FL-501,Tampa/Hillsborough County CoC,1931,6240062,3231.518384,1817,6242867,3435.810127,-114,204.2917423,1549,6129972,3957.37379,-268,521.563663,1795,6347400,3536.155989,246,-421.2178007,1650,6685221,4051.649091,-145,515.4931021,1748.4,3642.501476
TN-501,Memphis/Shelby County CoC,1525,6716521,4404.276066,1669,6706950,4018.544038,144,-385.7320272,1426,6557779,4598.723001,-243,580.1789631,1226,6773478,5524.859706,-200,926.136705,1325,6916270,5219.826415,99,-305.0332913,1434.2,4753.245845
VA-521,Virginia Balance of State CoC,773,808025,1045.310479,654,891945,1363.830275,-119,318.5197966,722,928840,1286.481994,68,-77.34828077,718,1062938,1480.415042,-4,193.9330473,761,1414751,1859.068331,43,378.6532894,725.6,1407.021224
IL-500,McHenry County CoC,177,930933,5259.508475,154,975924,6337.168831,-23,1077.660357,155,927850,5986.129032,1,-351.0397989,179,948095,5296.620112,24,-689.5089205,159,964871,6068.371069,-20,771.7509575,164.8,5789.559504
NC-504,"Greensboro, High Point CoC",665,1891697,2844.657143,721,2006402,2782.804438,56,-61.85270458,573,1991106,3474.879581,-148,692.0751429,657,1901691,2894.506849,84,-580.3727318,586,2134339,3642.216724,-71,747.7098742,640.4,3127.812947
TN-507,Jackson/West Tennessee CoC,1563,1490638,953.703135,1541,1546745,1003.728099,-22,50.02496364,1103,1467428,1330.397099,-438,326.6690002,1026,1679678,1637.11306,-77,306.7159616,959,1674735,1746.334724,-67,109.2216632,1238.4,1334.255223
GA-500,Atlanta CoC,4317,6921341,1603.275654,4063,6979344,1717.78095,-254,114.5052956,3572,7041634,1971.342105,-491,253.5611552,3076,7533177,2449.01723,-496,477.6751249,3217,7701216,2393.912341,141,-55.10488948,3649,2027.065656
TN-512,"Morristown/Blount, Sevier, Campbell, Cocke Counties CoC",966,393584,407.436853,630,492136,781.168254,-336,373.731401,752,485154,645.1515957,122,-136.0166582,798,531317,665.8107769,46,20.6591812,515,607384,1179.386408,-283,513.5756308,732.2,735.7907775
OH-503,Columbus/Franklin County CoC,1721,12293012,7142.947124,1724,11968018,6942.0058,3,-200.9413233,1691,11469253,6782.526907,-33,-159.4788933,1807,12763762,7063.509685,116,280.9827774,1907,15093005,7914.528055,100,851.01837,1770,7169.103514
TN-506,Upper Cumberland CoC,362,731977,2022.035912,249,780613,3134.991968,-113,1112.956056,252,713437,2831.099206,3,-303.8927615,258,750733,2909.817829,6,78.71862311,273,761972,2791.106227,15,-118.7116024,278.8,2737.810228
FL-505,"Fort Walton Beach/Okaloosa, Walton Counties CoC",683,576097,843.4802343,629,574187,912.8569157,-54,69.37668148,401,605695,1510.461347,-228,597.6044309,495,676587,1366.842424,94,-143.6189224,399,637295,1597.230576,-96,230.3881522,521.4,1246.174299
WA-500,Seattle/King County CoC,10122,35389214,3496.266943,10730,34457083,3211.284529,608,-284.9824139,11643,34134466,2931.758653,913,-279.5258761,12112,40191419,3318.313986,469,386.5553329,11199,47515340,4242.819895,-913,924.5059085,11161.2,3440.088801
IL-517,"Aurora, Elgin/Kane County CoC",388,1621013,4177.868557,355,1622893,4571.529577,-33,393.6610208,360,1718394,4773.316667,5,201.7870892,430,1821498,4236.04186,70,-537.2748062,388,1909460,4921.28866,-42,685.2467993,384.2,4536.009064
KS-502,Wichita/Sedgwick County CoC,561,2138663,3812.233512,571,2479662,4342.665499,10,530.4319875,575,2501271,4350.036522,4,7.371022615,573,2671577,4662.438045,-2,312.4015236,593,2694231,4543.391231,20,-119.0468143,574.6,4342.152962
FL-510,"Jacksonville-Duval, Clay Counties CoC",1853,4597556,2481.141932,1959,4447876,2270.482899,106,-210.6590326,1869,4337190,2320.5939,-90,50.11100104,1794,4659124,2597.059086,-75,276.4651854,1654,5277974,3191.036276,-140,593.9771899,1825.8,2572.062819
NJ-500,Atlantic City & County CoC,548,519206,947.4562044,476,519516,1091.420168,-72,143.9639637,422,555007,1315.182464,-54,223.7622964,437,541425,1238.95881,15,-76.22365439,357,590105,1652.955182,-80,413.996372,448,1249.194566
FL-511,"Pensacola/Escambia, Santa Rosa Counties CoC",1014,836821,825.2672584,798,784376,982.9273183,-216,157.6600599,758,707257,933.0567282,-40,-49.87059006,632,815404,1290.196203,-126,357.1394743,518,790987,1527.001931,-114,236.805728,744,1111.689888
OH-507,Ohio Balance of State CoC,3320,17483191,5266.021386,3032,16189733,5339.621702,-288,73.6003163,3309,15821746,4781.428226,277,-558.1934758,3133,19116526,6101.66805,-176,1320.239824,3479,20720684,5955.931015,346,-145.7370351,3254.6,5488.934076
FL-502,"St. Petersburg, Clearwater, Largo/Pinellas County CoC",3387,4036255,1191.690286,2777,4037891,1454.047893,-610,262.357607,2831,3957412,1397.884846,54,-56.16304707,2612,4129427,1580.944487,-219,183.0596406,2415,4534495,1877.637681,-197,296.6931942,2804.4,1500.441039
FL-519,Pasco County CoC,1019,763038,748.8105986,1055,886629,840.4066351,36,91.59603644,2593,839421,323.7258002,1538,-516.6808348,2668,911344,341.5832084,75,17.85740816,894,1281554,1433.505593,-1774,1091.922384,1645.8,737.606367
SC-503,"Myrtle Beach, Sumter City & County CoC",1319,1844036,1398.056103,1322,1918122,1450.924357,3,52.86825393,974,1946301,1998.255647,-348,547.3312898,1092,2522901,2310.348901,118,312.0932543,1153,2399428,2081.030356,61,-229.3185455,1172,1847.723073
NC-513,Chapel Hill/Orange County CoC,129,625299,4847.27907,80,656714,8208.925,-49,3361.64593,127,664478,5232.110236,47,-2976.814764,152,700219,4606.703947,25,-625.4062889,131,723974,5526.519084,-21,919.8151366,123.8,5684.307467
MA-504,Springfield/Hampden County CoC,3002,3230835,1076.227515,2385,3479984,1459.112788,-617,382.8852733,2311,3623415,1567.899178,-74,108.7863896,3368,4218711,1252.586401,1057,-315.3127764,2443,4229898,1731.435939,-925,478.849538,2701.8,1417.452364
NV-500,Las Vegas/Clark County CoC,7509,13469396,1793.766946,6208,13484302,2172.084729,-1301,378.3177831,6490,13204268,2034.555932,282,-137.5287972,6083,14236132,2340.314319,-407,305.7583864,5530,13540428,2448.540325,-553,108.2260069,6364,2157.85245
VA-502,"Roanoke City & County, Salem CoC",390,837812,2148.235897,308,835191,2711.659091,-82,563.4231935,267,805322,3016.187266,-41,304.528175,317,890645,2809.605678,50,-206.5815877,319,890645,2791.990596,2,-17.61508262,320.2,2695.535706
MO-500,St. Louis County CoC,438,1598248,3648.968037,465,1947438,4188.03871,27,539.0706731,462,1928309,4173.829004,-3,-14.20970535,450,2053080,4562.4,-12,388.5709957,487,2089196,4289.930185,37,-272.4698152,460.4,4172.633187
MO-600,"Springfield/Greene, Christian, Webster Counties CoC",584,865457,1481.946918,496,901775,1818.094758,-88,336.1478403,455,950006,2087.925275,-41,269.8305167,479,1073726,2241.599165,24,153.6738902,492,1042632,2119.170732,13,-122.4284332,501.2,1949.747369
MO-606,Missouri Balance of State CoC,1477,4553354,3082.83954,1431,4942202,3453.670161,-46,370.8306211,1244,4978996,4002.40836,-187,548.7381994,1345,4948339,3679.062454,101,-323.3459066,1362,5056332,3712.431718,17,33.36926453,1371.8,3586.082446
FL-514,Ocala/Marion County CoC,787,243373,309.2414231,823,190997,232.0741191,36,-77.16730405,725,245601,338.76,-98,106.6858809,572,292129,510.715035,-153,171.955035,475,444531,935.8547368,-97,425.1397019,676.4,465.3290628
MO-503,"St. Charles City & County, Lincoln, Warren Counties CoC",803,292226,363.9178082,610,287447,471.2245902,-193,107.3067819,578,334324,578.4152249,-32,107.1906347,532,381847,717.7575188,-46,139.3422939,438,429294,980.1232877,-94,262.3657689,592.2,622.287686
NJ-502,Burlington County CoC,1347,514068,381.6391982,926,478083,516.2883369,-421,134.6491387,604,511508,846.8675497,-322,330.5792127,840,504223,600.2654762,236,-246.6020735,518,515342,994.8687259,-322,394.6032497,847,667.9858574
OK-505,Northeast Oklahoma CoC,343,364189,1061.77551,368,364564,990.6630435,25,-71.11246673,377,352044,933.8037135,9,-56.85932995,392,382756,976.4183673,15,42.61465382,228,381431,1672.942982,-164,696.5246151,341.6,1127.120723
SC-502,Columbia/Midlands CoC,1468,3053383,2079.961172,1350,2856086,2115.619259,-118,35.6580876,1200,3101397,2584.4975,-150,468.8782407,1205,3224294,2675.762656,5,91.2651556,1215,3266455,2688.440329,10,12.67767362,1287.6,2428.856183
VA-505,"Newport News, Hampton/Virginia Peninsula CoC",520,2015935,3876.798077,464,2017216,4347.448276,-56,470.6501989,512,1955738,3819.800781,48,-527.6474946,439,2014410,4588.633257,-73,768.8324762,427,1912704,4479.400468,-12,-109.232789,472.4,4222.416172
NY-520,"Franklin, Essex Counties CoC",28,89223,3186.535714,27,88936,3293.925926,-1,107.3902116,28,80261,2866.464286,1,-427.4616402,42,90741,2160.5,14,-705.9642857,24,90801,3783.375,-18,1622.875,29.8,3058.160185
SC-501,"Greenville, Anderson, Spartanburg/Upstate CoC",1961,3291688,1678.576237,1829,3240222,1771.581192,-132,93.00495529,1317,2820022,2141.246773,-512,369.6655811,1185,3154564,2662.079325,-132,520.8325519,1401,3179446,2269.411849,216,-392.6674762,1538.6,2104.579075
CO-500,Colorado Balance of State CoC,3545,2874257,810.7918195,3520,2870432,815.4636364,-25,4.6718169,4019,2810881,699.398109,499,-116.0655274,3989,3082384,772.7209827,-30,73.32287372,2302,3222996,1400.085143,-1687,627.3641607,3475,899.6919382
DE-500,Delaware Statewide CoC,953,7785779,8169.757608,1070,7858054,7343.975701,117,-825.7819066,994,7723605,7770.226358,-76,426.2506572,1082,8249505,7624.31146,88,-145.9148979,921,8065668,8757.511401,-161,1133.19994,1004,7933.156506
TX-500,San Antonio/Bexar County CoC,2891,8329314,2881.118644,2781,8654457,3111.994606,-110,230.8759622,2743,8867223,3232.67335,-38,120.6787441,3066,9729143,3173.236464,323,-59.4368859,2872,9935694,3459.503482,-194,286.2670174,2870.6,3171.705309
FL-509,"Fort Pierce/St. Lucie, Indian River, Martin Counties CoC",2412,1514817,628.0335821,2382,1577584,662.2938707,-30,34.26028861,1732,1629149,940.6172055,-650,278.3233348,1542,1710063,1108.990272,-190,168.3730668,1499,1803072,1202.8499,-43,93.85962756,1913.4,908.5569661
HI-500,Hawaii Balance of State CoC,2717,2100869,773.2311373,2981,2146702,720.1281449,264,-53.10299237,2261,2344347,1036.862893,-720,316.7347476,2035,2613196,1284.125799,-226,247.262906,1995,2667935,1337.310777,-40,53.18497842,2397.8,1030.33175
NJ-503,"Camden City & County/Gloucester, Cape May, Cumberland Counties CoC",1089,3452067,3169.942149,1068,3548788,3322.835206,-21,152.8930572,938,3451535,3679.67484,-130,356.8396341,999,3703084,3706.790791,61,27.11595071,979,3651993,3730.329928,-20,23.53913771,1014.6,3521.914583
NY-513,"Wayne, Ontario, Seneca, Yates Counties CoC",187,205102,1096.802139,58,314662,5425.206897,-129,4328.404758,337,303702,901.1928783,279,-4524.014018,182,329297,1809.324176,-155,908.1312975,205,338057,1649.058537,23,-160.2656392,193.8,2176.316925
PA-505,Chester County CoC,612,1618855,2645.187908,558,1642543,2943.625448,-54,298.4375395,578,1626834,2814.591696,20,-129.0337525,579,1707231,2948.585492,1,133.9937967,528,1686204,3193.568182,-51,244.9826896,571,2909.111745
NC-503,North Carolina Balance of State CoC,3021,7399611,2449.391261,2963,8409964,2838.327371,-58,388.9361097,3054,8286424,2713.301899,91,-125.0254718,2991,8933958,2986.946841,-63,273.6449414,2989,8941246,2991.38374,-2,4.43689986,3003.6,2795.870222
FL-517,"Hendry, Hardee, Highlands Counties CoC",1218,190199,156.1568144,1071,179216,167.3352007,-147,11.1783863,609,158206,259.7799672,-462,92.44476641,453,184256,406.7461369,-156,146.9661697,398,277591,697.4648241,-55,290.7186873,749.8,337.4965887
NY-604,"Yonkers, Mount Vernon/Westchester County CoC",1797,18422848,10252.00223,1750,15997082,9141.189714,-47,-1110.812512,1832,17058955,9311.656659,82,170.4669451,1827,18848370,10316.56814,-5,1004.911485,1812,19556693,10792.87693,-15,476.3087871,1803.6,9962.858735
CA-520,Merced City & County CoC,898,659165,734.0367483,516,738049,1430.327519,-382,696.2907711,454,712751,1569.936123,-62,139.608604,514,749892,1458.933852,60,-111.0022712,608,774302,1273.523026,94,-185.4108258,598,1293.351454
CA-508,Watsonville/Santa Cruz City & County CoC,1964,2261790,1151.624236,1959,1953274,997.0770801,-5,-154.5471561,2249,2556056,1136.530013,290,139.4529332,2320,2629841,1133.552155,71,-2.977858167,2167,3662605,1690.17305,-153,556.6208951,2131.8,1221.791307
VA-504,Charlottesville CoC,185,369106,1995.167568,157,364572,2322.11465,-28,326.9470821,160,356702,2229.3875,3,-92.72714968,183,380319,2078.245902,23,-151.1415984,165,417497,2530.284848,-18,452.0389468,170,2231.040093
MD-507,Cecil County CoC,191,244476,1279.979058,167,244476,1463.928144,-24,183.9490861,193,244872,1268.766839,26,-195.1613043,129,255444,1980.186047,-64,711.4192071,126,228213,1811.214286,-3,-168.9717608,161.2,1560.814875
AZ-500,Arizona Balance of State CoC,2402,4010427,1669.6199,2240,3999989,1785.709375,-162,116.0894749,1768,3880375,2194.78224,-472,409.0728648,2187,4028471,1842.007773,419,-352.7744666,2021,4441226,2197.538842,-166,355.531069,2123.6,1937.931626
NE-500,Nebraska Balance of State CoC,549,2023586,3685.948998,551,2027150,3679.038113,2,-6.910885656,506,1989734,3932.280632,-45,253.2425199,559,2042862,3654.493739,53,-277.7868936,506,2107373,4164.768775,-53,510.2750359,534.2,3823.306051
TN-504,Nashville-Davidson County CoC,2154,3233243,1501.041318,2365,3234117,1367.491332,211,-133.5499866,2337,3107210,1329.572101,-28,-37.91923094,2298,3594038,1563.985205,-39,234.4131035,1986,3925354,1976.512588,-312,412.5273836,2228,1547.720509
NY-603,"Nassau, Suffolk Counties CoC",3861,10453402,2707.433825,3960,10612648,2679.961616,99,-27.47220927,3937,11808209,2999.291085,-23,319.3294684,3868,13156123,3401.272751,-69,401.9816662,3843,12225380,3181.20739,-25,-220.0653607,3893.8,2993.833333
NC-516,Northwest North Carolina CoC,755,287951,381.392053,520,288831,555.4442308,-235,174.0521778,466,273671,587.276824,-54,31.83259327,449,355786,792.3964365,-17,205.1196125,417,354661,850.5059952,-32,58.10955868,521.4,633.4031079
TX-601,"Fort Worth, Arlington/Tarrant County CoC",1914,11955827,6246.513584,1938,11323933,5843.102683,24,-403.4109009,1941,11923476,6142.955178,3,299.8524946,2015,13306444,6603.694293,74,460.7391151,2028,13604830,6708.496055,13,104.8017624,1967.2,6308.952359
GU-500,Guam CoC,1280,1122558,876.9984375,1085,1121767,1033.886636,-195,156.8881984,852,1054700,1237.910798,-233,204.0241622,854,1136986,1331.36534,2,93.45454146,875,1170412,1337.613714,21,6.248374707,989.2,1163.554985
MI-518,Livingston County CoC,103,219545,2131.504854,77,219006,2844.233766,-26,712.7289119,103,224593,2180.514563,26,-663.7192031,90,223694,2485.488889,-13,304.9743258,89,230486,2589.730337,-1,104.2414482,92.4,2446.294482
MN-505,St. Cloud/Central Minnesota CoC,696,1373986,1974.117816,669,1406233,2101.992526,-27,127.8747101,862,1348207,1564.045244,193,-537.9472825,584,1585286,2714.530822,-278,1150.485578,679,1649942,2429.958763,95,-284.572059,698,2156.929034
WA-501,Washington Balance of State CoC,5489,6227178,1134.483148,5706,6373115,1116.914651,217,-17.56849687,5243,6904013,1316.805836,-463,199.8911851,5666,8049065,1420.590364,423,103.7845272,5509,8730488,1584.768197,-157,164.1778339,5522.6,1314.712439
MO-602,"Joplin/Jasper, Newton Counties CoC",258,533918,2069.449612,297,549936,1851.636364,39,-217.8132488,270,560852,2077.22963,-27,225.593266,275,625968,2276.247273,5,199.0176431,237,596816,2518.21097,-38,241.9636977,267.4,2158.55477
NJ-509,Morris County CoC,384,1756326,4573.765625,410,1780503,4342.690244,26,-231.0753811,378,1721613,4554.531746,-32,211.8415021,398,1939213,4872.394472,20,317.8627263,388,1947345,5018.930412,-10,146.53594,391.6,4672.4625
NE-501,"Omaha, Council Bluffs CoC",1481,4224258,2852.301148,1509,4235409,2806.765408,28,-45.53574032,1389,4543501,3271.059035,-120,464.2936277,1411,4692702,3325.798724,22,54.73968903,1410,4630609,3284.119858,-1,-41.67886615,1440,3108.008835
HI-501,Honolulu City and County CoC,4903,9265576,1889.776871,4940,9372980,1897.364372,37,7.587501166,4959,9080553,1831.125832,19,-66.23854065,4495,9483399,2109.766185,-464,278.6403528,4417,10249234,2320.406158,-78,210.6399734,4742.8,2009.687884
VA-514,"Fredericksburg/Spotsylvania, Stafford Counties CoC",217,273082,1258.442396,209,273731,1309.717703,-8,51.27530704,216,298606,1382.435185,7,72.71748184,200,320381,1601.905,-16,219.4698148,221,367448,1662.660633,21,60.75563348,212.6,1443.032184
NY-500,"Rochester, Irondequoit, Greece/Monroe County CoC",762,11127315,14602.77559,860,11853955,13783.6686,98,-819.1069859,817,12080024,14785.83109,-43,1002.162485,835,12511442,14983.76287,18,197.9317849,849,12736174,15001.3828,14,17.61992905,824.6,14631.48419
MT-500,Montana Statewide CoC,1709,2583192,1511.522528,1418,2446282,1725.163611,-291,213.6410829,1529,2434677,1592.332897,111,-132.8307134,1405,2681779,1908.739502,-124,316.4066045,1357,2573182,1896.228445,-48,-12.51105668,1483.6,1726.797397
ID-500,Boise/Ada County CoC,755,933085,1235.874172,867,901578,1039.882353,112,-195.9918192,833,889887,1068.291717,-34,28.40936375,756,1073322,1419.738095,-77,351.4463786,713,1146029,1607.333801,-43,187.5957056,784.8,1274.224028
FL-518,"Columbia, Hamilton, Lafayette, Suwannee Counties CoC",1115,357005,320.1838565,1145,357356,312.10131,30,-8.082546459,502,339388,676.0717131,-643,363.9704031,493,360919,732.0872211,-9,56.01550795,538,365487,679.3438662,45,-52.74335492,758.6,543.9575934
KS-507,Kansas Balance of State CoC,1208,2539223,2102.005795,903,2594677,2873.396456,-305,771.3906616,1037,2502835,2413.534233,134,-459.8622229,918,2651388,2888.222222,-119,474.6879889,1056,2592210,2454.744318,138,-433.477904,1024.4,2546.380605
CA-504,"Santa Rosa, Petaluma/Sonoma County CoC",3097,3087262,996.8556668,2906,3076336,1058.615279,-191,61.75961196,2835,3222762,1136.77672,-71,78.16144084,2996,3721504,1242.157543,161,105.3808238,2951,3976410,1347.478821,-45,105.3212773,2957,1156.376806
MA-506,Worcester City & County CoC,1682,6595065,3920.966112,1572,6357364,4044.124682,-110,123.1585702,1507,6195279,4111.001327,-65,66.87664521,1852,6737485,3637.950864,345,-473.0504632,1593,6792560,4264.005022,-259,626.054158,1641.2,3995.609601
IA-500,"Sioux City/Dakota, Woodbury Counties CoC",276,715112,2590.985507,348,712980,2048.793103,72,-542.1924038,288,722532,2508.791667,-60,459.9985632,264,763143,2890.693182,-24,381.9015152,255,747036,2929.552941,-9,38.85975936,286.2,2593.76328
FL-503,"Lakeland, Winterhaven/Polk County CoC",464,1614059,3478.575431,635,1636029,2576.423622,171,-902.151809,512,1787775,3491.748047,-123,915.3244248,552,1974655,3577.273551,40,85.52550385,563,2147661,3814.673179,11,237.3996287,545.2,3387.738766
FL-508,"Gainesville/Alachua, Putnam Counties CoC",870,587341,675.1045977,844,627897,743.9537915,-26,68.84919377,819,662578,809.008547,-25,65.05475554,756,703177,930.1283069,-63,121.1197599,804,809057,1006.289801,48,76.16149412,818.6,832.8970088
MD-509,Frederick City & County CoC,311,569765,1832.041801,349,568257,1628.243553,38,-203.7982476,309,581619,1882.262136,-40,254.0185829,316,638037,2019.10443,7,136.8422945,286,617594,2159.41958,-30,140.31515,314.2,1904.2143
SD-500,South Dakota Statewide CoC,1036,1126640,1087.490347,1072,1264095,1179.193097,36,91.70274952,943,1241586,1316.634146,-129,137.4410493,1159,1316523,1135.912856,216,-180.7212904,995,1402574,1409.622111,-164,273.7092546,1041,1225.770511
MN-500,Minneapolis/Hennepin County CoC,3215,11815635,3675.158631,3056,11814366,3865.957461,-159,190.7988293,3057,12013665,3929.887144,1,63.92968353,3013,12955703,4299.934617,-44,370.0474724,3400,13516105,3975.325,387,-324.6096167,3148.2,3949.252571
FL-604,Monroe County CoC,615,448854,729.8439024,575,471296,819.6452174,-40,89.80131495,631,479542,759.9714739,56,-59.67374354,973,491912,505.5621788,342,-254.409295,501,515579,1029.0998,-472,523.5376216,659,768.8245146
IL-518,"Rock Island, Moline/Northwestern Illinois CoC",254,858536,3380.062992,340,943042,2773.652941,86,-606.4100509,243,902842,3715.399177,-97,941.7462358,198,740232,3738.545455,-45,23.14627759,211,776138,3678.379147,13,-60.16630763,249.2,3457.207942
VI-500,Virgin Islands CoC,337,115754,343.4836795,341,107651,315.6920821,4,-27.79159741,381,108794,285.5485564,40,-30.14352568,486,192882,396.8765432,105,111.3279868,314,197155,627.8821656,-172,231.0056224,371.8,393.8966054
MA-505,New Bedford CoC,437,1688210,3863.180778,469,1739069,3708.036247,32,-155.1445307,352,1683752,4783.386364,-117,1075.350116,409,1817917,4444.784841,57,-338.6015226,433,1793295,4141.558891,24,-303.2259496,420,4188.189424
NC-501,Asheville/Buncombe County CoC,562,1206824,2147.373665,509,1206060,2369.469548,-53,222.0958827,562,1254274,2231.80427,53,-137.6652777,554,1276279,2303.752708,-8,71.94843712,580,1406554,2425.093103,26,121.3403959,553.4,2295.498659
WY-500,Wyoming Statewide CoC,798,300615,376.7105263,857,291611,340.2695449,59,-36.44098139,873,264399,302.862543,16,-37.40700197,639,288790,451.9405321,-234,149.0779891,548,358277,653.790146,-91,201.8496139,743,425.1146585
CO-503,Metropolitan Denver CoC,5335,24388048,4571.330459,5728,24256915,4234.796613,393,-336.5338461,5506,24567573,4461.963858,-222,227.1672445,5317,27195633,5114.845402,-189,652.8815439,5755,27901716,4848.256473,438,-266.5889289,5528.2,4646.238561
CA-515,"Roseville, Rocklin/Placer County CoC",796,1256067,1577.973618,1021,1269692,1243.576885,225,-334.3967327,979,1227123,1253.445352,-42,9.868466994,950,1291551,1359.527368,-29,106.082016,617,1142431,1851.589951,-333,492.062583,872.6,1457.222635
NY-511,"Binghamton, Union Town/Broome, Otsego, Chenango, Delaware, Cortland, Tioga Count",302,1563384,5176.768212,276,1607135,5822.952899,-26,646.1846866,308,1591655,5167.711039,32,-655.2418596,244,1689334,6923.5,-64,1755.788961,318,1730234,5440.987421,74,-1482.512579,289.6,5706.383914
FL-520,"Citrus, Hernando, Lake, Sumter Counties CoC",731,396759,542.7619699,595,450265,756.7478992,-136,213.9859293,635,370361,583.2456693,40,-173.5022299,711,428405,602.5386779,76,19.29300863,677,540839,798.8759232,-34,196.3372453,669.8,656.8340279
PA-501,Harrisburg/Dauphin County CoC,402,1623714,4039.089552,433,1683543,3888.090069,31,-150.999483,460,1671218,3633.082609,27,-255.0074606,445,1835657,4125.07191,-15,491.9893014,418,1790241,4282.873206,-27,157.8012956,431.6,3993.641469
FL-506,Tallahassee/Leon County CoC,863,1341674,1554.662804,869,1341171,1543.349827,6,-11.31297678,1072,1291383,1204.648321,203,-338.7015065,909,1451760,1597.09571,-163,392.4473887,966,1730217,1791.114907,57,194.0191973,935.8,1538.174314
FL-512,St. Johns County CoC,1161,139559,120.205857,1064,133345,125.3242481,-97,5.1183911,445,121598,273.2539326,-619,147.9296845,342,133307,389.7865497,-103,116.5326171,356,126034,354.0280899,14,-35.75845982,673.6,252.5197355
AR-503,Arkansas  Balance of State  CoC,774,397224,513.2093023,761,426096,559.9159001,-13,46.70659781,875,401154,458.4617143,114,-101.4541858,768,377488,491.5208333,-107,33.05911905,811,588711,725.9075216,43,234.3866882,797.8,549.8030543
OK-507,Southeastern Oklahoma Regional CoC,453,113981,251.6136865,436,120983,277.483945,-17,25.87025842,351,116835,332.8632479,-85,55.37930291,244,131146,537.4836066,-107,204.6203587,293,135511,462.4948805,49,-74.98872601,355.4,372.3878733
NC-507,Raleigh/Wake County CoC,904,3013496,3333.513274,818,3187757,3897.013447,-86,563.5001731,884,3247452,3673.588235,66,-223.4252121,983,3451506,3511.196338,99,-162.3918976,970,3436755,3543.046392,-13,31.85005401,911.8,3591.671537
FL-500,"Sarasota, Bradenton/Manatee, Sarasota Counties CoC",1198,1113950,929.8414023,1468,871530,593.6852861,270,-336.1561162,1447,799101,552.2467173,-21,-41.43856876,1192,0,0,-255,-552.2467173,1135,1290692,1137.173568,-57,1137.173568,1288,642.5893948
CA-509,Mendocino County CoC,947,1776020,1875.417107,1242,1701242,1369.760064,295,-505.6570422,1238,1570243,1268.370759,-4,-101.3893051,880,1619702,1840.570455,-358,572.1996953,785,1634537,2082.212739,-95,241.6422843,1018.4,1687.266225
IL-503,"Champaign, Urbana, Rantoul/Champaign County CoC",163,748586,4592.552147,188,710403,3778.739362,25,-813.8127855,160,692843,4330.26875,-28,551.5293883,188,724099,3851.590426,28,-478.6783245,151,723261,4789.807947,-37,938.2175215,170,4268.591726
PA-510,Lancaster City & County CoC,378,2007820,5311.693122,356,2311097,6491.845506,-22,1180.152384,321,2296691,7154.800623,-35,662.9551174,406,2322334,5720.034483,85,-1434.76614,422,2321243,5500.575829,16,-219.4586534,376.6,6035.789913
CA-603,Santa Maria/Santa Barbara County CoC,1729,1607635,929.8062464,1813,1667801,919.9123001,84,-9.89394633,1860,1684716,905.7612903,47,-14.15100973,1706,1995819,1169.882181,-154,264.1208902,1803,2014213,1117.145313,97,-52.73686717,1782.2,1008.501466
OK-502,Oklahoma City CoC,1300,3507094,2697.764615,1511,3230712,2138.128392,211,-559.6362236,1368,3558289,2601.08845,-143,462.9600585,1183,3796648,3209.338969,-185,608.2505184,1273,3668978,2882.150825,90,-327.1881439,1327,2705.69425
NJ-513,Somerset County CoC,342,397461,1162.166667,218,416211,1909.224771,-124,747.058104,244,412830,1691.92623,26,-217.2985411,218,398093,1826.114679,-26,134.1884494,301,404421,1343.591362,83,-482.5233168,264.6,1586.604742
GA-504,Augusta-Richmond County CoC,407,604090,1484.250614,287,622090,2167.560976,-120,683.3103614,246,607258,2468.528455,-41,300.9674797,269,615226,2287.085502,23,-181.4429534,384,635710,1655.494792,115,-631.5907102,318.6,2012.584068
MD-505,Baltimore County CoC,745,2766391,3713.27651,763,2766391,3625.676278,18,-87.60023222,609,2794107,4588.024631,-154,962.3483527,758,3004848,3964.17942,149,-623.845211,735,2853973,3882.956463,-23,-81.22295694,722,3954.82266
FL-513,"Palm Bay, Melbourne/Brevard County CoC",1072,719252,670.9440299,827,687401,831.1983071,-245,160.2542773,845,666117,788.304142,18,-42.89416512,734,742388,1011.427793,-111,223.1236509,815,680214,834.6184049,81,-176.809388,858.6,827.2985354
TX-607,Texas Balance of State CoC,7016,7686653,1095.589082,6048,6499737,1074.691964,-968,-20.89711781,7153,5854328,818.4437299,1105,-256.2482344,7638,7342787,961.349437,485,142.9057071,8072,10108120,1252.244797,434,290.8953598,7185.4,1040.463802
CA-527,Tehama County CoC,138,5629,40.78985507,133,5511,41.43609023,-5,0.646235153,124,0,0,-9,-41.43609023,125,5902,47.216,1,47.216,288,56563,196.3993056,163,149.1833056,161.6,65.16825017
MD-504,Howard County CoC,166,789594,4756.590361,214,785410,3670.140187,48,-1086.450175,168,768634,4575.202381,-46,905.062194,168,809573,4818.886905,0,243.6845238,201,984426,4897.641791,33,78.75488628,183.4,4543.692325
CA-518,Vallejo/Solano County CoC,1082,1254088,1159.046211,1118,1288063,1152.113596,36,-6.932615014,1232,1247979,1012.969968,114,-139.1436282,1129,1464224,1296.921169,-103,283.9512016,1151,1486257,1291.274544,22,-5.646625301,1142.4,1182.465097
MI-505,Flint/Genesee County CoC,488,2294131,4701.088115,377,2105600,5585.145889,-111,884.0577738,420,2008079,4781.140476,43,-804.0054124,438,1959934,4474.73516,18,-306.4053164,450,2168179,4818.175556,12,343.4403957,434.6,4872.057039
DC-500,District of Columbia CoC,7298,23888687,3273.319677,8350,21198186,2538.70491,1052,-734.6147664,7473,21497405,2876.676703,-877,337.9717926,6904,22720536,3290.923523,-569,414.2468198,6521,22075117,3385.234933,-383,94.3114107,7309.2,3072.971949
FL-606,Naples/Collier County CoC,389,270198,694.596401,545,278807,511.5724771,156,-183.023924,621,286151,460.7906602,76,-50.78181684,653,297734,455.9479326,32,-4.842727607,498,399823,802.8574297,-155,346.9094971,541.2,585.1529801
CA-513,"Visalia/Kings, Tulare Counties CoC",862,1923277,2231.179814,792,2087201,2635.354798,-70,404.1749836,853,2257440,2646.471278,61,11.11647986,967,2354941,2435.306101,114,-211.1651765,1064,2474301,2325.470865,97,-109.8352367,907.6,2454.756571
AK-501,Alaska Balance of State CoC,748,762763,1019.736631,835,760458,910.7281437,87,-109.0084873,717,776502,1082.987448,-118,172.259304,922,812671,881.4219089,205,-201.5655388,796,879834,1105.319095,-126,223.8971866,803.6,1000.038645
FL-601,Ft Lauderdale/Broward County CoC,2615,10376919,3968.229063,2302,10375134,4507.008688,-313,538.779625,2450,9505090,3879.628571,148,-627.3801167,2318,10201816,4401.128559,-132,521.4999877,2803,11362648,4053.745273,485,-347.3832862,2497.6,4161.948031
TX-624,"Wichita Falls/Wise, Palo Pinto, Wichita, Archer Counties CoC",267,324611,1215.771536,256,301888,1179.25,-11,-36.52153558,234,306206,1308.57265,-22,129.3226496,238,333323,1400.516807,4,91.94415715,243,315554,1298.576132,5,-101.940675,247.6,1280.537425
AR-501,Fayetteville/Northwest Arkansas CoC,665,394778,593.6511278,550,382645,695.7181818,-115,102.067054,330,345423,1046.736364,-220,351.0181818,474,356625,752.3734177,144,-294.3629459,518,348954,673.6563707,44,-78.71704707,507.4,752.4270923
MI-515,Monroe City & County CoC,185,139126,752.0324324,176,129387,735.1534091,-9,-16.87902334,193,131448,681.0777202,17,-54.07568888,209,125684,601.3588517,16,-79.71886853,167,137413,822.8323353,-42,221.4734837,186,718.4909497
CA-614,San Luis Obispo County CoC,1515,935156,617.2646865,1368,928536,678.754386,-147,61.4896995,1125,906615,805.88,-243,127.125614,1095,979997,894.9744292,-30,89.09442922,1483,1013800,683.6142953,388,-211.3601339,1317.2,736.0975594
MD-506,Carroll County CoC,140,390079,2786.278571,136,390453,2870.977941,-4,84.69936975,147,394953,2686.755102,11,-184.2228391,173,414519,2396.063584,26,-290.6915182,144,408642,2837.791667,-29,441.7280829,148,2715.573373
FL-605,West Palm Beach/Palm Beach County CoC,1421,5682950,3999.261084,1332,4946880,3713.873874,-89,-285.3872099,1607,5203892,3238.26509,275,-475.6087836,1309,5795007,4427.048892,-298,1188.783802,1397,5656703,4049.178955,88,-377.8699374,1413.2,3885.525579
MI-511,Lenawee County CoC,128,108386,846.765625,137,107596,785.3722628,9,-61.39336223,128,103011,804.7734375,-9,19.40117473,117,103083,881.0512821,-11,76.27784455,123,110262,896.4390244,6,15.38774234,126.6,842.8803263
IL-513,Springfield/Sangamon County CoC,326,445540,1366.687117,261,438717,1680.908046,-65,314.2209294,230,415203,1805.230435,-31,124.3223888,271,402569,1485.494465,41,-319.7359698,284,402128,1415.943662,13,-69.55080297,274.4,1550.852745
VA-602,Loudoun County CoC,172,167720,975.1162791,134,167480,1249.850746,-38,274.7344672,113,177752,1573.026549,-21,323.1758024,134,181940,1357.761194,21,-215.2653546,167,171024,1024.095808,33,-333.6653856,144,1235.970115
OK-500,North Central Oklahoma CoC,194,279491,1440.675258,129,286706,2222.527132,-65,781.8518741,192,257918,1343.322917,63,-879.2042151,181,267124,1475.823204,-11,132.5002878,178,263480,1480.224719,-3,4.401514681,174.8,1592.514646
MD-511,Mid-Shore Regional CoC,158,723480,4578.987342,138,687157,4979.398551,-20,400.411209,153,742947,4855.862745,15,-123.5358056,141,746719,5295.879433,-12,440.0166875,164,757156,4616.804878,23,-679.0745546,150.8,4865.38659
MI-510,Saginaw City & County CoC,308,1806174,5864.201299,343,1806174,5265.813411,35,-598.3878876,388,1884846,4857.850515,45,-407.9628956,357,2039269,5712.238095,-31,854.3875798,364,2148310,5901.950549,7,189.7124542,352,5520.410774
VA-501,"Norfolk, Chesapeake, Suffolk/Isle of Wight, Southampton Counties CoC",735,3912825,5323.571429,723,3903688,5399.29184,-12,75.72041099,703,3770092,5362.86202,-20,-36.42981964,773,3869707,5006.089263,70,-356.7727573,700,3749505,5356.435714,-73,350.3464517,726.8,5289.650053
MA-509,Cambridge CoC,464,4164930,8976.142241,517,4141665,8010.957447,53,-965.1847946,530,4322638,8155.920755,13,144.9633079,561,4701678,8380.887701,31,224.9669458,555,4994743,8999.536937,-6,618.6492364,525.4,8504.689016
CA-524,Yuba City & County/Sutter County CoC,716,2490,3.477653631,702,2490,3.547008547,-14,0.069354916,760,0,0,58,-3.547008547,765,15455,20.20261438,5,20.20261438,721,15548,21.56449376,-44,1.36187938,732.8,9.758354063
CA-530,"Alpine, Inyo, Mono Counties CoC",53,0,0,130,3091,23.77692308,77,23.77692308,121,0,0,-9,-23.77692308,157,3134,19.96178344,36,19.96178344,214,2962,13.8411215,57,-6.120661944,135,11.5159656
CA-506,"Salinas/Monterey, San Benito Counties CoC",2959,1972200,666.5089557,3022,1967620,651.0986102,63,-15.41034554,3364,1802763,535.8986326,342,-115.1999776,3299,1840661,557.9451349,-65,22.04650231,2704,1798544,665.1420118,-595,107.1968769,3069.6,615.318669
CA-525,El Dorado County CoC,269,10556,39.24163569,269,9817,36.49442379,0,-2.747211896,602,9817,16.30730897,333,-20.18711482,645,20017,31.03410853,43,14.72679956,613,20153,32.87601958,-32,1.841911049,479.6,31.19069931
MN-506,Northwest Minnesota CoC,254,673035,2649.744094,290,672506,2318.986207,36,-330.7578876,288,672592,2335.388889,-2,16.40268199,274,736023,2686.215328,-14,350.8264396,268,707636,2640.432836,-6,-45.78249265,274.8,2526.153471
UT-503,Utah Balance of State CoC,646,1640766,2539.885449,738,1819427,2465.348238,92,-74.53721043,634,1858855,2931.94795,-104,466.599711,899,1817218,2021.377086,265,-910.5708639,793,1998751,2520.493064,-106,499.1159787,742,2495.810357
CA-517,Napa City & County CoC,293,712708,2432.450512,317,715483,2257.044164,24,-175.4063479,315,725047,2301.736508,-2,44.6923439,322,739826,2297.596273,7,-4.140234645,322,775531,2408.481366,0,110.8850932,313.8,2339.461765
FL-515,"Panama City/Bay, Jackson Counties CoC",317,42952,135.4952681,310,52529,169.4483871,-7,33.95311896,336,30765,91.5625,26,-77.8858871,381,53680,140.8923885,45,49.32988845,488,53995,110.6454918,107,-30.24689665,366.4,129.6088071
KS-505,"Overland Park, Shawnee/Johnson County CoC",174,675358,3881.367816,153,677397,4427.431373,-21,546.0635565,130,684593,5266.1,-23,838.6686275,168,683573,4068.886905,38,-1197.213095,189,727890,3851.269841,21,-217.6170635,162.8,4299.011187
NY-600,New York City CoC,75323,121965844,1619.237736,73523,107493608,1462.040559,-1800,-157.1971774,76501,106684572,1394.551339,2978,-67.48921954,78676,117583916,1494.533479,2175,99.98213988,78604,124630884,1585.553967,-72,91.02048764,76525.4,1511.183416
PA-500,Philadelphia CoC,5998,35522132,5922.329443,6112,33542976,5488.052356,114,-434.2770871,5693,32870833,5773.903566,-419,285.8512098,5788,34507318,5961.872495,95,187.968929,5735,33751218,5885.129555,-53,-76.74293946,5865.2,5806.257483
CA-611,"Oxnard, San Buenaventura/Ventura County CoC",1417,1970367,1390.520113,1271,2174740,1711.04642,-146,320.5263072,1152,2189139,1900.294271,-119,189.2478507,1308,2290478,1751.129969,156,-149.1643014,1669,2258458,1353.180348,361,-397.9496219,1363.4,1621.234224
OR-502,"Medford, Ashland/Jackson County CoC",729,282942,388.1234568,527,265111,503.056926,-202,114.9334692,633,244882,386.8593997,106,-116.1975263,732,248204,339.0765027,99,-47.78289695,712,248461,348.9620787,-20,9.885575919,666.6,393.2156728
CA-500,San Jose/Santa Clara City & County CoC,6556,20204762,3081.873398,6524,20015353,3067.957235,-32,-13.91616359,7394,21305510,2881.459291,870,-186.4979435,7254,26061937,3592.767714,-140,711.308423,9706,29506119,3039.987533,2452,-552.7801809,7486.8,3132.809034
CA-600,Los Angeles City & County CoC,41174,100267671,2435.218123,43854,104971653,2393.661992,2680,-41.55613102,52442,108148295,2062.245814,8588,-331.4161776,49955,123707061,2476.369953,-2487,414.1241385,56257,133611222,2375.015056,6302,-101.3548971,48736.4,2348.502188
TN-502,Knoxville/Knox County CoC,783,1401099,1789.398467,748,1390506,1858.965241,-35,69.56677321,812,1373859,1691.944581,64,-167.0206594,743,1412759,1901.425303,-69,209.4807215,800,1379782,1724.7275,57,-176.6978028,777.2,1793.292218
GA-503,Athens-Clarke County CoC,226,696892,3083.59292,224,663759,2963.209821,-2,-120.3830989,239,709605,2969.058577,15,5.848755977,212,761981,3594.25,-27,625.1914226,237,715218,3017.797468,25,-576.4525316,227.6,3125.581758
OR-505,Oregon Balance of State CoC,5544,3081444,555.8160173,5710,3134740,548.9912434,166,-6.824773883,5795,3065532,528.9960311,85,-19.99521237,6392,3233919,505.9322591,597,-23.06377199,7103,3343537,470.7218077,711,-35.21045139,6108.8,522.0914717
MI-513,"Marquette, Alger Counties CoC",79,194878,2466.810127,70,131967,1885.242857,-9,-581.5672694,84,124049,1476.77381,14,-408.4690476,70,132120,1887.428571,-14,410.6547619,53,125725,2372.169811,-17,484.7412399,71.2,2017.685035
NC-506,"Wilmington/Brunswick, New Hanover, Pender Counties CoC",390,671285,1721.24359,389,668205,1717.750643,-1,-3.49294707,322,656683,2039.388199,-67,321.6375561,333,696261,2090.873874,11,51.48567512,431,699688,1623.406032,98,-467.4678414,373,1838.532468
NV-502,Nevada Balance of State CoC,327,610198,1866.04893,201,574995,2860.671642,-126,994.6227121,237,539475,2276.265823,36,-584.405819,269,598552,2225.100372,32,-51.16545104,383,676545,1766.436031,114,-458.6643404,283.4,2198.904559
MA-503,Cape Cod Islands CoC,362,1932912,5339.535912,394,1758102,4462.187817,32,-877.3480943,324,1598108,4932.432099,-70,470.2442815,358,1852407,5174.321229,34,241.8891303,371,1938900,5226.145553,13,51.82432351,361.8,5026.924522
MA-519,"Attleboro, Taunton/Bristol County CoC",240,819144,3413.1,243,798948,3287.851852,3,-125.2481481,234,785012,3354.752137,-9,66.9002849,208,820990,3947.067308,-26,592.3151709,256,843063,3293.214844,48,-653.8524639,236.2,3459.197228
MI-514,Battle Creek/Calhoun County CoC,285,326673,1146.221053,246,305356,1241.284553,-39,95.06350021,204,297131,1456.52451,-42,215.239957,236,304409,1289.868644,32,-166.6558657,241,240887,999.5311203,5,-290.3375237,242.4,1226.685976
WA-504,Everett/Snohomish County CoC,829,7900826,9530.55006,960,7982600,8315.208333,131,-1215.341727,1066,7823734,7339.337711,106,-975.8706223,858,9868888,11502.20047,-208,4162.862755,1116,10464602,9376.883513,258,-2125.316954,965.8,9212.836017
MI-508,"Lansing, East Lansing/Ingham County CoC",418,2566614,6140.22488,471,2551559,5417.322718,53,-722.9021628,435,2427581,5580.645977,-36,163.3232594,419,2551336,6089.107399,-16,508.4614216,476,2848116,5983.436975,57,-105.6704238,443.8,5842.14759
CA-522,Humboldt County CoC,1180,819897,694.8279661,1134,822933,725.6904762,-46,30.86251009,759,834362,1099.291173,-375,373.6006964,703,861315,1225.199147,-56,125.9079739,1702,903714,530.9717979,999,-694.2273486,1095.6,855.1961119
CA-521,"Davis, Woodland/Yolo County CoC",498,474575,952.9618474,532,487860,917.0300752,34,-35.9317722,459,476153,1037.37037,-73,120.3402952,448,481697,1075.216518,-11,37.84614749,655,516569,788.6549618,207,-286.561556,518.4,954.2467545
NV-501,"Reno, Sparks/Washoe County CoC",907,1575244,1736.762955,989,1703062,1722.004044,82,-14.75891031,1106,1654208,1495.667269,117,-226.336775,1192,1625336,1363.536913,86,-132.1303567,1256,1973370,1571.154459,64,207.6175458,1090,1577.825128
OR-503,Central Oregon CoC,594,569835,959.3181818,602,597510,992.5415282,8,33.22334642,778,596396,766.5758355,176,-225.9656928,787,665492,845.6060991,9,79.03026363,880,668408,759.5545455,93,-86.05155366,728.2,864.719238
TN-510,Murfreesboro/Rutherford County CoC,289,554745,1919.532872,306,525674,1717.888889,17,-201.6439831,316,616756,1951.759494,10,233.8706048,283,636524,2249.201413,-33,297.4419198,384,656875,1710.611979,101,-538.5894343,315.6,1909.798929
OK-501,Tulsa City & County CoC,956,2736752,2862.711297,1043,2794032,2678.841802,87,-183.8694946,1074,2589093,2410.701117,31,-268.1406852,1083,2808449,2593.212373,9,182.5112557,1188,3150860,2652.239057,105,59.0266842,1068.8,2639.541129
CA-613,Imperial County CoC,554,191131,345.0018051,380,191704,504.4842105,-174,159.4824055,1154,161815,140.2209705,774,-364.26324,1493,183793,123.103148,339,-17.11782251,1413,186875,132.2540694,-80,9.150921332,998.8,249.0128407
ID-501,Idaho Balance of State CoC,1211,2780683,2296.187448,1380,2767872,2005.704348,169,-290.4831006,1204,2720641,2259.668605,-176,253.9642568,1256,3253348,2590.245223,52,330.5766183,1602,3310283,2066.343945,346,-523.9012779,1330.6,2243.629914
WA-508,Vancouver/Clark County CoC,662,1517539,2292.354985,688,1738388,2526.726744,26,234.3717593,749,1931121,2578.265688,61,51.5389434,795,1957595,2462.383648,46,-115.8820398,958,1973789,2060.322547,163,-402.0611008,770.4,2384.010722
NY-516,Clinton County CoC,143,146329,1023.27972,132,143907,1090.204545,-11,66.92482517,126,146634,1163.761905,-6,73.55735931,197,0,0,71,-1163.761905,164,129549,789.9329268,-33,789.9329268,152.4,813.4358195
CA-526,"Amador, Calaveras, Mariposa, Tuolumne Counties CoC",430,313840,729.8604651,632,313976,496.7974684,202,-233.0629968,367,301121,820.493188,-265,323.6957197,398,406899,1022.359296,31,201.8661085,845,409325,484.408284,447,-537.9510125,534.4,710.7837404
NM-501,New Mexico Balance of State CoC,1342,4611587,3436.353949,1041,4963571,4768.079731,-301,1331.725782,1164,4978569,4277.121134,123,-490.958597,1211,5614726,4636.437655,47,359.3165208,1717,5458209,3178.921957,506,-1457.515698,1295,4059.382885
CA-608,Riverside City & County CoC,2372,9289429,3916.285413,2165,9385526,4335.115935,-207,418.8305222,2406,9649536,4010.613466,241,-324.502469,2316,10106803,4363.904577,-90,353.2911105,2811,10281317,3657.53006,495,-706.3745164,2414,4056.68989
WA-503,"Tacoma, Lakewood/Pierce County CoC",1283,3449147,2688.345284,1762,3303548,1874.885358,479,-813.4599269,1321,3221135,2438.40651,-441,563.5211527,1628,3449417,2118.806511,307,-319.5999992,1486,3609841,2429.233513,-142,310.4270017,1496,2309.935435
AL-503,Huntsville/North Alabama CoC,420,754922,1797.433333,385,703494,1827.257143,-35,29.82380952,436,650007,1490.841743,51,-336.4153997,424,664538,1567.306604,-12,76.46486065,464,711592,1533.603448,40,-33.7031555,425.8,1643.288454
CA-516,"Redding/Shasta, Siskiyou, Lassen, Plumas, Del Norte, Modoc, Sierra Counties CoC",591,317347,536.9661591,1272,346705,272.5668239,681,-264.3993352,934,317347,339.7719486,-338,67.20512471,1149,354508,308.5361184,215,-31.23583024,1349,365267,270.7687176,200,-37.7674008,1059,345.7219535
CA-609,San Bernardino City & County CoC,2149,9366053,4358.330852,1887,10339584,5479.376789,-262,1121.045937,1866,10066156,5394.510182,-21,-84.86660635,2118,10141456,4788.222852,252,-606.2873305,2607,10622832,4074.734177,489,-713.4886745,2125.4,4819.03497
GA-506,Marietta/Cobb County CoC,415,2200358,5302.06747,405,2152110,5313.851852,-10,11.78438197,403,2123692,5269.707196,-2,-44.14465582,384,2301469,5993.408854,-19,723.7016581,451,2250609,4990.263858,67,-1003.144996,411.6,5373.859846
MN-503,"Dakota, Anoka, Washington, Scott, Carver Counties",608,3758883,6182.373355,618,3775053,6108.5,10,-73.87335526,544,3819588,7021.301471,-74,912.8014706,625,3868141,6189.0256,81,-832.2758706,686,4020020,5860.087464,61,-328.9381364,616.2,6272.257578
CA-510,"Turlock, Modesto/Stanislaus County CoC",1408,2963830,2104.992898,1434,3110273,2168.949093,26,63.95619572,1661,3135250,1887.56773,227,-281.3813632,1356,3399756,2507.19469,-305,619.62696,1923,3384296,1759.904316,567,-747.2903741,1556.4,2085.721746
NY-503,Albany City & County CoC,597,5040772,8443.504188,748,5154071,6890.469251,151,-1553.034936,802,4935437,6153.911471,54,-736.55778,835,5663416,6782.534132,33,628.6226604,750,6054612,8072.816,-85,1290.281868,746.4,7268.647008
MN-509,Duluth/St.Louis County CoC,490,3271748,6677.036735,528,3045367,5767.74053,38,-909.2962044,505,2963567,5868.449505,-23,100.7089746,425,3277549,7711.88,-80,1843.430495,519,3262299,6285.739884,94,-1426.140116,493.4,6462.169331
MD-502,Harford County CoC,210,927130,4414.904762,179,920787,5144.061453,-31,729.1566906,189,917958,4856.920635,10,-287.1408176,190,928419,4886.415789,1,29.49515455,228,914622,4011.5,38,-874.9157895,199.2,4662.760528
MD-512,Hagerstown/Washington County CoC,201,503819,2506.562189,233,501992,2154.472103,32,-352.0900861,208,480051,2307.9375,-25,153.465397,199,517913,2602.577889,-9,294.6403894,249,519913,2088.004016,50,-514.5738734,218,2331.91074
NY-608,Kingston/Ulster County CoC,343,1169100,3408.45481,328,1166718,3557.067073,-15,148.6122627,411,1138244,2769.450122,83,-787.6169515,464,1235605,2662.94181,53,-106.5083113,432,1278269,2958.956019,-32,296.0142082,395.6,3071.373967
CA-519,"Chico, Paradise/Butte County CoC",571,533470,934.2732049,574,528301,920.3850174,3,-13.88818748,1195,542712,454.1523013,621,-466.2327162,1125,552718,491.3048889,-70,37.15258763,1266,611447,482.9755134,141,-8.329375461,946.2,656.6181852
CA-511,Stockton/San Joaquin County CoC,1708,4180278,2447.469555,1780,4290724,2410.519101,72,-36.95045391,1542,4285672,2779.294423,-238,368.7753217,1685,4490004,2664.690801,143,-114.6036216,2631,5207322,1979.217788,946,-685.4730133,1869.2,2456.238334
AZ-502,"Phoenix, Mesa/Maricopa County CoC",5631,26882333,4773.989167,5702,25418465,4457.815679,71,-316.1734884,5605,25129344,4483.379839,-97,25.56416072,6298,28016529,4448.480311,693,-34.89952822,6614,28412341,4295.787874,316,-152.692437,5970,4491.890574
OK-503,Oklahoma Balance of State CoC,237,605541,2555.025316,295,578363,1960.552542,58,-594.4727741,432,567890,1314.560185,137,-645.9923572,233,607607,2607.755365,-199,1293.19518,279,578604,2073.849462,46,-533.9059024,295.2,2102.348574
WV-500,"Wheeling, Weirton Area CoC",114,412132,3615.192982,91,413181,4540.450549,-23,925.257567,118,403829,3422.279661,27,-1118.170888,108,424200,3927.777778,-10,505.4981168,136,423756,3115.852941,28,-811.9248366,113.4,3724.310782
VA-513,"Harrisburg, Winchester/Western Virginia CoC",242,385552,1593.190083,268,361353,1348.33209,26,-244.8579931,280,362880,1296,12,-52.33208955,304,371331,1221.483553,24,-74.51644737,342,368464,1077.380117,38,-144.1034357,287.2,1307.277168
OR-500,"Eugene, Springfield/Lane County CoC",1473,3361210,2281.880516,1451,3377840,2327.939352,-22,46.05883622,1529,3363526,2199.820798,78,-128.1185543,1641,3608512,2198.971359,112,-0.84943898,2165,3735118,1725.227714,524,-473.7436453,1651.8,2146.767948
CA-604,Bakersfield/Kern County CoC,954,4790096,5021.06499,1067,5469432,5125.990628,113,104.9256384,810,5376223,6637.312346,-257,1511.321718,885,5921458,6690.912994,75,53.60064867,1330,5926586,4456.079699,445,-2234.833295,1009.2,5586.272131
WA-502,Spokane City & County CoC,1034,3822547,3696.853965,981,3776210,3849.347604,-53,152.4936393,1090,3675649,3372.155046,109,-477.1925586,1245,3778347,3034.816867,155,-337.3381784,1309,4085440,3121.038961,64,86.22209357,1131.8,3414.842489
NH-501,Manchester CoC,400,1537898,3844.745,400,1544841,3862.1025,0,17.3575,394,1479633,3755.413706,-6,-106.6887944,427,1543817,3615.496487,33,-139.9172185,461,1503148,3260.624729,34,-354.8717583,416.4,3667.676484
KS-503,Topeka/Shawnee County CoC,405,1867911,4612.125926,381,1780468,4673.144357,-24,61.01843103,356,1883942,5291.97191,-25,618.8275532,408,1871426,4586.828431,52,-705.1434787,441,1754485,3978.424036,33,-608.4043951,398.2,4628.498932
PA-506,Reading/Berks County CoC,561,3327453,5931.28877,521,2828868,5429.68906,-40,-501.5997106,534,2762261,5172.773408,13,-256.9156513,562,2923439,5201.848754,28,29.07534621,597,3156551,5287.355109,35,85.50635443,555,5404.59102
MN-501,Saint Paul/Ramsey County CoC,1398,6964024,4981.41917,1346,6976719,5183.29792,-52,201.8787495,1438,7001581,4868.971488,92,-314.3264316,1424,6994909,4912.155197,-14,43.18370845,1579,6806892,4310.887904,155,-601.2672929,1437,4851.346336
CA-612,Glendale CoC,208,2319804,11152.90385,240,2371801,9882.504167,32,-1270.399679,168,2347395,13972.58929,-72,4090.085119,260,2449400,9420.769231,92,-4551.820055,243,2540381,10454.2428,-17,1033.473568,223.8,10976.60187
CO-504,Colorado Springs/El Paso County CoC,1073,2452453,2285.603914,1302,2443940,1877.066052,229,-408.537862,1415,2333697,1649.25583,113,-227.8102218,1551,2407701,1552.353965,136,-96.9018652,1562,2467848,1579.928297,11,27.57433187,1380.6,1788.841612
NJ-504,Newark/Essex County CoC,1610,5738188,3564.091925,1779,6604274,3712.351883,169,148.2599576,2048,6035911,2947.222168,269,-765.1297151,2228,6442940,2891.804309,180,-55.41785917,2235,6376138,2852.858166,7,-38.94614325,1980,3193.66569
TX-611,Amarillo CoC,478,711031,1487.512552,592,595303,1005.579392,114,-481.9331604,531,603751,1137.007533,-61,131.4281411,665,592838,891.4857143,134,-245.5218187,777,585037,752.9433719,112,-138.5423423,608.6,1054.905713
NM-500,Albuquerque CoC,1287,5681370,4414.428904,1222,5794442,4741.769231,-65,327.3403263,1318,5432713,4121.937026,96,-619.832205,1340,5572933,4158.905224,22,36.96819808,1524,5567279,3653.07021,184,-505.8350139,1338.2,4218.022119
CA-514,Fresno City & County/Madera County CoC,1722,8737368,5073.965157,1883,9006586,4783.10462,161,-290.8605365,2016,9124064,4525.825397,133,-257.2792235,2144,10733261,5006.185168,128,480.3597711,2508,10662668,4251.46252,364,-754.722648,2054.6,4728.108572
MI-507,"Portage, Kalamazoo City & County CoC",568,1777855,3130.026408,374,1730134,4626.026738,-194,1496.00033,479,1644924,3434.079332,105,-1191.947406,567,1672455,2949.656085,88,-484.4232473,702,1566257,2231.135328,135,-718.520757,538,3274.184778
NY-602,"Newburgh, Middletown/Orange County CoC",495,2792412,5641.236364,343,2743298,7997.953353,-152,2356.716989,350,2549566,7284.474286,7,-713.4790671,480,2708938,5643.620833,130,-1640.853452,589,2755959,4679.047538,109,-964.5732951,451.4,6249.266475
NJ-516,"Warren, Sussex, Hunterdon Counties CoC",255,1222609,4794.545098,253,1224785,4841.047431,-2,46.50233279,286,1174640,4107.132867,33,-733.9145637,338,1253501,3708.58284,52,-398.5500269,334,1268835,3798.907186,-4,90.32434539,293.2,4250.043084
NY-601,Poughkeepsie/Dutchess County CoC,375,1338245,3568.653333,385,1338222,3475.901299,10,-92.75203463,388,1297157,3343.188144,3,-132.7131544,399,1373608,3442.626566,11,99.43842209,533,1353027,2538.512195,134,-904.1143713,416,3273.776308
NY-606,Rockland County CoC,117,727899,6221.358974,141,731495,5187.907801,24,-1033.451173,170,803640,4727.294118,29,-460.6136838,180,902136,5011.866667,10,284.572549,182,935678,5141.087912,2,129.2212454,158,5257.903094
CA-602,"Santa Ana, Anaheim/Orange County CoC",4452,22025895,4947.415768,4319,22354847,5175.931234,-133,228.5154659,4792,22807570,4759.509599,473,-416.4216347,4955,24073151,4858.355399,163,98.84579926,6860,26143204,3810.962682,1905,-1047.392716,5075.6,4710.434936
NY-510,Ithaca/Tompkins County CoC,88,211918,2408.159091,86,197057,2291.360465,-2,-116.7986258,73,209140,2864.931507,-13,573.5710417,91,217267,2387.549451,18,-477.3820563,171,213365,1247.748538,80,-1139.800913,101.8,2239.94981
AR-500,Little Rock/Central Arkansas CoC,830,3359964,4048.149398,808,3213437,3977.02599,-22,-71.12340749,1006,3107871,3089.33499,198,-887.691,1081,3142641,2907.160962,75,-182.174028,1066,3027153,2839.730769,-15,-67.43019284,958.2,3372.280422
AL-504,Montgomery City & County CoC,441,2112078,4789.292517,367,2105613,5737.365123,-74,948.0726056,377,1970964,5228.02122,10,-509.3439025,369,1243676,3370.395664,-8,-1857.625556,330,1176724,3565.830303,-39,195.4346391,376.8,4538.180965
WI-502,Racine City & County CoC,168,1055535,6282.946429,196,874678,4462.642857,28,-1820.303571,194,828832,4272.329897,-2,-190.3129602,275,977863,3555.865455,81,-716.4644424,200,1001094,5005.47,-75,1449.604545,206.6,4715.850927
MN-504,Northeast Minnesota CoC,68,442121,6501.779412,77,441917,5739.181818,9,-762.5975936,99,431158,4355.131313,22,-1384.050505,90,460318,5114.644444,-9,759.5131313,90,463344,5148.266667,0,33.62222222,84.8,5371.800731
OH-501,Toledo/Lucas County CoC,564,4267657,7566.76773,599,4180179,6978.595993,35,-588.1717372,499,4143741,8304.09018,-100,1325.494187,662,3955340,5974.833837,163,-2329.256344,611,3781149,6188.459902,-51,213.6260649,587,7002.549529
TN-503,Central Tennessee CoC,268,1819533,6789.302239,296,1816073,6135.381757,28,-653.920482,285,1783153,6256.677193,-11,121.2954362,268,1862709,6950.406716,-17,693.7295234,357,1931293,5409.784314,89,-1540.622403,294.8,6308.310444
NY-607,Sullivan County CoC,130,394588,3035.292308,163,366967,2251.331288,33,-783.9610193,167,303643,1818.221557,4,-433.1097315,189,281080,1487.195767,22,-331.0257897,162,265715,1640.216049,-27,153.0202822,162.2,2046.451394
MO-603,"St. Joseph/Andrew, Buchanan, DeKalb Counties CoC",164,1257604,7668.317073,195,1258363,6453.14359,31,-1215.173483,210,1239738,5903.514286,15,-549.629304,204,1430323,7011.387255,-6,1107.872969,255,1590352,6236.67451,51,-774.7127451,205.6,6654.607343
TX-600,"Dallas City & County, Irving CoC",3141,16629599,5294.364534,3810,15979190,4194.013123,669,-1100.35141,3789,15725259,4150.239905,-21,-43.77321837,4121,16562289,4018.997573,332,-131.2423316,4538,17036008,3754.078449,417,-264.9191247,3879.8,4282.338717
OK-504,Norman/Cleveland County CoC,133,373113,2805.360902,138,408358,2959.115942,5,153.7550398,174,402933,2315.706897,36,-643.4090455,364,431668,1185.901099,190,-1129.805798,347,426422,1228.881844,-17,42.98074548,231.2,2098.993337
MA-502,Lynn CoC,445,1784969,4011.166292,541,1732766,3202.89464,96,-808.2716526,582,1793614,3081.810997,41,-121.083643,1061,1908352,1798.63525,479,-1283.175747,1035,2297466,2219.773913,-26,421.1386633,732.8,2862.856218
NY-518,"Utica, Rome/Oneida, Madison Counties CoC",140,3120929,22292.35,160,3110204,19438.775,20,-2853.575,162,3200761,19757.78395,2,319.0089506,178,3248035,18247.38764,16,-1510.39631,168,3443985,20499.91071,-10,2252.523074,161.6,20047.24146
NY-519,"Columbia, Greene Counties CoC",97,451459,4654.216495,116,450923,3887.267241,19,-766.9492535,144,450819,3130.6875,28,-756.5797414,196,464344,2369.102041,52,-761.5854592,200,517778,2588.89,4,219.7879592,150.6,3326.032655
GA-502,Fulton County CoC,473,2795919,5911.033827,483,2604210,5391.73913,10,-519.2946962,293,2495096,8515.686007,-190,3123.946876,222,2497367,11249.4009,-71,2733.714894,632,2430457,3845.65981,410,-7403.741091,420.6,6982.703935
CA-502,"Oakland, Berkeley/Alameda County CoC",4040,28980863,7173.480941,4145,33998867,8202.380458,105,1028.899518,5629,34329783,6098.735655,1484,-2103.644804,5496,37648221,6850.112991,-133,751.3773366,8022,36369614,4533.733982,2526,-2316.37901,5466.4,6571.688805
MD-500,Cumberland/Allegany County CoC,96,699622,7287.729167,124,650648,5247.16129,28,-2040.567876,118,661652,5607.220339,-6,360.0590487,79,668444,8461.316456,-39,2854.096117,145,625121,4311.17931,66,-4150.137145,112.4,6182.921312
CA-503,Sacramento City & County CoC,2659,19138664,7197.692366,2500,19511838,7804.7352,-159,607.0428344,3665,19599048,5347.625648,1165,-2457.109552,3621,20915190,5776.081193,-44,428.455545,5561,23349292,4198.757777,1940,-1577.323416,3601.2,6064.978437
NY-514,"Jamestown, Dunkirk/Chautauqua County CoC",29,210878,7271.655172,23,217879,9473,-6,2201.344828,83,201899,2432.518072,60,-7040.481928,145,199474,1375.682759,62,-1056.835314,96,254503,2651.072917,-49,1275.390158,75.2,4640.785784
MD-510,Garrett County CoC,9,255878,28430.88889,20,237274,11863.7,11,-16567.18889,10,242699,24269.9,-10,12406.2,15,244208,16280.53333,5,-7989.366667,12,229819,19151.58333,-3,2871.05,13.2,19999.32111
